date,new,NTotal_ExposureOnly,domestic-contactWithCase,domestic-contactWithTraveller,domestic-unknown,internationalTravel,infopending,cumulative,cumulativeNTotal_ExposureOnly,doubleFlagTest,shaded
2020-01-15,2,1,0,0,0,1,0,2,1,1,14
2020-01-16,5,3,1,0,2,0,0,7,4,1,
2020-01-17,1,1,0,0,0,1,0,8,5,0,
2020-01-18,0,0,0,0,0,0,0,8,5,0,
2020-01-19,0,0,0,0,0,0,0,8,5,0,
2020-01-20,1,0,0,0,0,0,0,9,5,0,
2020-01-21,4,0,0,0,0,0,0,13,5,0,
2020-01-22,5,4,1,0,1,2,0,18,9,1,
2020-01-23,0,0,0,0,0,0,0,18,9,0,
2020-01-24,3,2,0,0,0,2,0,21,11,0,
2020-01-25,3,2,1,0,1,0,0,24,13,0,
2020-01-26,2,1,1,0,0,0,0,26,14,0,
2020-01-27,8,3,2,0,1,0,0,34,17,0,
2020-01-28,6,2,1,0,0,1,0,40,19,1,
2020-01-29,2,1,0,0,0,0,1,42,20,0,
2020-01-30,2,1,1,0,0,0,0,44,21,0,
2020-01-31,2,1,0,0,1,0,0,46,22,0,
2020-02-01,5,5,3,0,1,1,0,51,27,0,
2020-02-02,3,2,0,0,1,1,0,54,29,0,
2020-02-03,1,1,0,0,1,0,0,55,30,0,
2020-02-04,2,2,0,0,2,0,0,57,32,0,
2020-02-05,3,3,1,0,1,1,0,60,35,0,
2020-02-06,0,0,0,0,0,0,0,60,35,0,
2020-02-07,0,0,0,0,0,0,0,60,35,0,
2020-02-08,1,0,0,0,0,0,0,61,35,0,
2020-02-09,1,1,0,0,0,1,0,62,36,0,
2020-02-10,2,2,0,0,1,1,0,64,38,0,
2020-02-11,2,1,0,0,1,0,0,66,39,0,
2020-02-12,4,3,2,0,1,0,0,70,42,0,
2020-02-13,1,1,0,0,0,1,0,71,43,0,
2020-02-14,6,5,0,0,3,2,0,77,48,0,
2020-02-15,3,2,1,0,0,1,0,80,50,1,
2020-02-16,1,1,0,0,0,1,0,81,51,0,
2020-02-17,2,2,1,0,0,1,0,83,53,0,
2020-02-18,2,2,2,0,0,0,0,85,55,0,
2020-02-19,4,4,2,0,1,1,0,89,59,0,
2020-02-20,9,9,3,1,3,2,0,98,68,0,
2020-02-21,3,3,0,0,1,2,0,101,71,0,
2020-02-22,8,8,2,0,3,3,0,109,79,0,
2020-02-23,22,22,11,0,3,7,1,131,101,0,
2020-02-24,15,14,3,0,2,9,0,146,115,0,
2020-02-25,16,16,4,0,2,10,0,162,131,1,
2020-02-26,14,13,6,1,4,2,0,176,144,0,
2020-02-27,27,26,12,0,7,7,0,203,170,0,
2020-02-28,39,37,17,0,6,14,0,242,207,0,
2020-02-29,27,27,8,0,7,12,0,269,234,0,
2020-03-01,60,59,12,0,26,20,1,329,293,1,
2020-03-02,56,56,8,0,18,30,0,385,349,0,
2020-03-03,55,55,15,0,12,28,0,440,404,0,
2020-03-04,62,58,13,1,14,30,0,502,462,0,
2020-03-05,67,67,12,1,23,31,0,569,529,0,
2020-03-06,86,85,17,2,26,40,0,655,614,0,
2020-03-07,91,91,14,3,30,44,0,746,705,1,
2020-03-08,135,134,27,2,45,60,0,881,839,0,
2020-03-09,224,223,44,10,79,90,0,1105,1062,0,
2020-03-10,256,254,55,9,72,118,0,1361,1316,0,
2020-03-11,295,295,74,11,84,125,1,1656,1611,1,
2020-03-12,390,389,92,9,128,159,1,2046,2000,0,
2020-03-13,466,461,125,8,151,175,2,2512,2461,0,
2020-03-14,468,466,98,15,168,183,2,2980,2927,0,
2020-03-15,605,601,152,10,212,225,2,3585,3528,1,
2020-03-16,848,839,253,10,308,267,1,4433,4367,0,
2020-03-17,871,865,260,16,320,264,5,5304,5232,0,
2020-03-18,972,964,281,19,358,302,4,6276,6196,0,
2020-03-19,811,802,253,13,297,236,3,7087,6998,0,
2020-03-20,1059,1054,363,21,423,238,9,8146,8052,1,
2020-03-21,909,895,320,8,326,237,4,9055,8947,0,
2020-03-22,872,861,320,13,341,185,2,9927,9808,0,
2020-03-23,1094,1080,465,16,417,173,9,11021,10888,0,
2020-03-24,995,986,398,21,390,173,4,12016,11874,0,
2020-03-25,1008,993,450,13,414,108,8,13024,12867,0,
2020-03-26,941,929,449,12,342,117,9,13965,13796,0,
2020-03-27,971,960,483,8,373,84,12,14936,14756,0,
2020-03-28,976,966,472,9,390,84,11,15912,15722,0,
2020-03-29,888,880,462,7,355,50,6,16800,16602,1,
2020-03-30,1180,1172,584,10,488,77,13,17980,17774,0,
2020-03-31,1009,1001,560,3,357,68,13,18989,18775,0,
2020-04-01,1325,1313,755,12,453,84,9,20314,20088,0,
2020-04-02,1194,1188,749,11,374,46,8,21508,21276,0,
2020-04-03,1339,1328,887,6,374,53,8,22847,22604,0,
2020-04-04,1174,1170,745,9,371,28,17,24021,23774,0,
2020-04-05,1079,1074,680,5,368,13,8,25100,24848,0,
2020-04-06,1441,1437,885,11,514,14,13,26541,26285,0,
2020-04-07,1309,1303,792,13,469,16,13,27850,27588,0,
2020-04-08,1407,1403,884,10,489,6,14,29257,28991,0,
2020-04-09,1507,1505,968,14,495,4,24,30764,30496,0,
2020-04-10,1812,1806,1137,19,620,6,24,32576,32302,0,
2020-04-11,1714,1711,971,11,686,4,39,34290,34013,1,
2020-04-12,1447,1444,888,16,506,7,27,35737,35457,0,
2020-04-13,2130,2128,1170,33,887,6,32,37867,37585,0,
2020-04-14,1820,1818,1094,21,668,2,33,39687,39403,0,
2020-04-15,1961,1954,1231,22,672,4,25,41648,41357,0,
2020-04-16,1962,1958,1105,19,778,1,55,43610,43315,0,
2020-04-17,1862,1858,1105,17,698,3,35,45472,45173,0,
2020-04-18,1620,1615,1041,20,524,3,27,47092,46788,0,
2020-04-19,1232,1227,743,15,454,4,11,48324,48015,0,
2020-04-20,1845,1841,1080,10,714,2,35,50169,49856,0,
2020-04-21,1412,1410,842,13,520,6,29,51581,51266,0,
2020-04-22,1571,1566,909,13,613,1,30,53152,52832,0,
2020-04-23,1579,1569,915,18,599,5,32,54731,54401,0,
2020-04-24,1539,1534,931,11,547,2,43,56270,55935,0,
2020-04-25,1406,1399,823,14,475,5,82,57676,57334,0,
2020-04-26,1317,1312,789,13,464,4,42,58993,58646,0,
2020-04-27,1656,1645,951,12,637,5,40,60649,60291,0,
2020-04-28,1531,1519,925,18,547,6,23,62180,61810,0,
2020-04-29,1487,1481,806,4,655,2,14,63667,63291,0,
2020-04-30,1472,1463,828,4,611,3,17,65139,64754,0,
2020-05-01,1593,1582,895,8,656,4,19,66732,66336,0,
2020-05-02,1071,1067,657,8,383,0,19,67803,67403,0,
2020-05-03,1023,1021,621,6,379,5,10,68826,68424,1,
2020-05-04,1364,1357,775,6,553,2,21,70190,69781,0,
2020-05-05,1302,1295,728,6,534,1,26,71492,71076,0,
2020-05-06,1127,1123,661,8,435,2,17,72619,72199,0,
2020-05-07,1178,1173,712,4,432,6,19,73797,73372,0,
2020-05-08,1183,1178,701,7,454,1,15,74980,74550,0,
2020-05-09,1024,1018,634,8,354,4,18,76004,75568,0,
2020-05-10,920,917,543,7,351,5,11,76924,76485,0,
2020-05-11,1226,1225,729,8,451,7,30,78150,77710,0,
2020-05-12,1165,1156,718,2,410,6,20,79315,78866,0,
2020-05-13,1106,1097,650,3,425,3,16,80421,79963,0,
2020-05-14,1160,1159,685,3,452,5,14,81581,81122,0,
2020-05-15,1216,1214,711,0,479,11,13,82797,82336,0,
2020-05-16,996,993,601,2,375,2,13,83793,83329,0,
2020-05-17,913,902,537,2,343,8,12,84706,84231,0,
2020-05-18,1091,1080,617,2,449,5,7,85797,85311,0,
2020-05-19,964,959,583,3,361,4,8,86761,86270,0,
2020-05-20,1123,1110,652,2,444,1,11,87884,87380,0,
2020-05-21,884,873,547,2,307,6,11,88768,88253,0,
2020-05-22,841,831,513,0,311,5,2,89609,89084,0,
2020-05-23,691,685,442,1,232,4,6,90300,89769,0,
2020-05-24,653,646,401,0,230,4,11,90953,90415,0,
2020-05-25,857,845,508,3,313,4,17,91810,91260,0,
2020-05-26,749,733,458,1,261,7,6,92559,91993,0,
2020-05-27,714,702,425,2,263,2,10,93273,92695,0,
2020-05-28,595,582,362,2,205,2,11,93868,93277,0,
2020-05-29,731,727,444,0,275,3,5,94599,94004,0,
2020-05-30,564,556,397,2,154,1,2,95163,94560,0,
2020-05-31,408,398,258,0,131,3,6,95571,94958,0,
2020-06-01,687,679,395,6,249,6,23,96258,95637,0,
2020-06-02,493,485,320,1,155,5,4,96751,96122,0,
2020-06-03,491,487,322,4,149,4,8,97242,96609,0,
2020-06-04,462,452,265,1,169,11,6,97704,97061,0,
2020-06-05,446,436,312,0,118,3,3,98150,97497,0,
2020-06-06,371,366,234,1,124,4,3,98521,97863,0,
2020-06-07,313,304,213,1,84,1,5,98834,98167,0,
2020-06-08,434,424,289,6,114,10,5,99268,98591,0,
2020-06-09,373,366,244,3,110,4,5,99641,98957,0,
2020-06-10,440,435,259,5,152,10,9,100081,99392,0,
2020-06-11,376,360,242,3,107,5,3,100457,99752,0,
2020-06-12,375,370,224,5,132,6,3,100832,100122,0,
2020-06-13,276,271,181,1,83,5,1,101108,100393,0,
2020-06-14,300,293,186,0,95,9,3,101408,100686,0,
2020-06-15,399,393,244,4,134,7,4,101807,101079,0,
2020-06-16,368,357,234,2,106,10,5,102175,101436,0,
2020-06-17,362,356,229,0,117,6,4,102537,101792,0,
2020-06-18,327,317,198,1,110,4,4,102864,102109,0,
2020-06-19,336,334,231,0,88,11,4,103200,102443,0,
2020-06-20,285,279,186,0,84,8,1,103485,102722,0,
2020-06-21,271,268,176,0,85,4,3,103756,102990,0,
2020-06-22,323,317,211,2,96,4,4,104079,103307,0,
2020-06-23,325,325,219,2,91,6,7,104404,103632,0,
2020-06-24,285,285,183,2,87,9,4,104689,103917,0,
2020-06-25,464,461,326,2,122,5,6,105153,104378,0,
2020-06-26,277,270,170,0,83,11,6,105430,104648,0,
2020-06-27,251,247,165,1,71,7,3,105681,104895,0,
2020-06-28,237,234,135,1,88,9,1,105918,105129,0,
2020-06-29,332,327,198,2,107,10,10,106250,105456,0,
2020-06-30,311,299,197,4,93,2,3,106561,105755,0,
2020-07-01,286,274,177,8,83,5,1,106847,106029,0,
2020-07-02,266,258,161,1,83,6,7,107113,106287,0,
2020-07-03,306,294,185,2,91,13,3,107419,106581,0,
2020-07-04,293,281,173,3,94,10,1,107712,106862,0,
2020-07-05,271,268,177,3,81,6,1,107983,107130,0,
2020-07-06,504,491,269,2,175,17,28,108487,107621,0,
2020-07-07,519,506,263,6,208,19,10,109006,108127,0,
2020-07-08,443,419,279,4,121,10,5,109449,108546,0,
2020-07-09,450,431,268,3,139,12,9,109899,108977,0,
2020-07-10,412,389,258,5,107,14,5,110311,109366,0,
2020-07-11,383,373,228,3,128,12,2,110694,109739,0,
2020-07-12,397,381,236,3,134,6,2,111091,110120,0,
2020-07-13,604,570,358,12,185,12,3,111695,110690,0,
2020-07-14,545,504,299,4,181,13,7,112240,111194,0,
2020-07-15,566,520,311,3,174,16,16,112806,111714,0,
2020-07-16,459,419,259,4,136,17,3,113265,112133,0,
2020-07-17,504,463,272,6,167,7,11,113769,112596,0,
2020-07-18,405,381,228,2,137,7,7,114174,112977,0,
2020-07-19,392,357,202,4,137,12,2,114566,113334,0,
2020-07-20,527,473,264,6,184,14,5,115093,113807,0,
2020-07-21,523,469,267,10,181,6,5,115616,114276,0,
2020-07-22,444,381,181,6,180,10,4,116060,114657,0,
2020-07-23,449,356,175,3,165,7,6,116509,115013,0,
2020-07-24,456,376,180,7,177,5,7,116965,115389,0,
2020-07-25,308,231,108,4,110,6,3,117273,115620,0,
2020-07-26,334,220,102,6,100,10,2,117607,115840,0,
2020-07-27,472,330,176,3,132,14,5,118079,116170,0,
2020-07-28,417,286,155,1,111,14,5,118496,116456,0,
2020-07-29,406,246,138,2,99,3,4,118902,116702,0,
2020-07-30,332,213,109,1,87,6,10,119234,116915,0,
2020-07-31,337,220,120,0,85,10,5,119571,117135,0,
2020-08-01,342,208,113,8,62,17,8,119913,117343,0,
2020-08-02,331,197,124,6,59,6,2,120244,117540,0,
2020-08-03,427,272,162,2,97,10,1,120671,117812,0,
2020-08-04,445,313,186,0,100,20,7,121116,118125,0,
2020-08-05,377,277,171,9,87,8,2,121493,118402,0,
2020-08-06,345,248,160,4,71,7,6,121838,118650,0,
2020-08-07,386,301,189,2,92,6,12,122224,118951,0,
2020-08-08,332,237,151,4,76,2,4,122556,119188,0,
2020-08-09,323,254,150,7,87,7,3,122879,119442,0,
2020-08-10,474,365,215,8,124,12,6,123353,119807,0,
2020-08-11,470,358,220,5,121,11,1,123823,120165,0,
2020-08-12,405,323,211,11,87,11,3,124228,120488,0,
2020-08-13,423,350,223,8,107,10,2,124651,120838,0,
2020-08-14,375,302,175,7,108,9,3,125026,121140,0,
2020-08-15,366,302,171,7,111,7,6,125392,121442,0,
2020-08-16,376,291,166,14,104,4,3,125768,121733,0,
2020-08-17,542,415,264,11,126,7,7,126310,122148,0,
2020-08-18,425,348,205,4,123,4,12,126735,122496,0,
2020-08-19,444,351,207,9,120,5,10,127179,122847,0,
2020-08-20,444,352,222,5,108,4,13,127623,123199,0,
2020-08-21,421,334,207,9,104,5,9,128044,123533,0,
2020-08-22,393,333,225,7,93,5,3,128437,123866,0,
2020-08-23,403,316,203,3,103,6,1,128840,124182,0,
2020-08-24,576,433,265,15,137,7,9,129416,124615,0,
2020-08-25,613,453,293,12,137,10,1,130029,125068,0,
2020-08-26,615,454,287,13,144,5,5,130644,125522,0,
2020-08-27,488,363,231,11,108,3,10,131132,125885,0,
2020-08-28,559,413,262,11,125,6,9,131691,126298,0,
2020-08-29,456,327,206,10,88,5,18,132147,126625,0,
2020-08-30,554,397,242,4,127,7,17,132701,127022,0,
2020-08-31,645,429,260,11,133,9,16,133346,127451,0,
2020-09-01,746,513,301,18,162,7,25,134092,127964,0,
2020-09-02,778,530,333,12,153,8,24,134870,128494,0,
2020-09-03,660,454,267,5,163,4,15,135530,128948,0,
2020-09-04,721,479,287,9,158,10,15,136251,129427,0,
2020-09-05,665,414,254,9,125,9,17,136916,129841,0,
2020-09-06,684,421,269,4,135,8,5,137600,130262,0,
2020-09-07,787,489,299,9,159,9,13,138387,130751,1,
2020-09-08,954,609,351,14,218,10,16,139341,131360,0,
2020-09-09,1011,627,375,12,216,4,20,140352,131987,0,
2020-09-10,1002,650,378,6,226,9,31,141354,132637,0,
2020-09-11,976,641,358,10,249,9,15,142330,133278,0,
2020-09-12,976,654,390,8,235,3,18,143306,133932,0,
2020-09-13,971,612,344,8,242,6,12,144277,134544,0,
2020-09-14,1263,804,481,14,275,7,27,145540,135348,0,
2020-09-15,1315,801,447,10,306,3,35,146855,136149,0,
2020-09-16,1356,817,494,22,272,4,25,148211,136966,0,
2020-09-17,1325,770,479,21,236,6,28,149536,137736,0,
2020-09-18,1421,804,518,8,241,1,36,150957,138540,0,
2020-09-19,1240,708,393,18,273,6,18,152197,139248,0,
2020-09-20,1358,759,419,12,282,9,37,153555,140007,0,
2020-09-21,1815,1014,559,16,377,6,56,155370,141021,0,
2020-09-22,1859,962,525,13,366,8,50,157229,141983,0,
2020-09-23,1912,1008,557,15,344,2,90,159141,142991,0,
2020-09-24,1956,985,526,10,355,2,92,161097,143976,0,
2020-09-25,2051,1061,564,20,371,9,97,163148,145037,0,
2020-09-26,1881,952,505,7,339,4,97,165029,145989,0,
2020-09-27,1969,968,479,10,352,6,121,166998,146957,0,
2020-09-28,2472,1197,624,16,420,3,134,169470,148154,0,
2020-09-29,2267,1127,552,23,406,3,143,171737,149281,0,
2020-09-30,2255,1127,564,16,435,1,111,173992,150408,0,
2020-10-01,2168,1113,586,9,415,9,94,176160,151521,0,
2020-10-02,2131,1083,549,17,404,9,104,178291,152604,0,
2020-10-03,1828,942,476,19,349,10,88,180119,153546,0,
2020-10-04,1841,922,511,14,315,4,78,181960,154468,0,
2020-10-05,2449,1267,677,20,455,4,111,184409,155735,0,
2020-10-06,2320,1261,677,31,422,10,121,186729,156996,0,
2020-10-07,2277,1261,689,20,435,9,108,189006,158257,0,
2020-10-08,2242,1192,657,14,405,10,106,191248,159449,0,
2020-10-09,2297,1249,655,18,457,7,112,193545,160698,0,
2020-10-10,2169,1340,682,17,553,7,81,195714,162038,0,
2020-10-11,1914,1119,605,17,398,5,94,197628,163157,0,
2020-10-12,2337,1340,717,19,501,8,95,199965,164497,0,
2020-10-13,2570,1524,866,22,520,9,107,202535,166021,0,
2020-10-14,2513,1523,879,27,509,7,101,205048,167544,0,
2020-10-15,2567,1419,842,24,445,9,99,207615,168963,0,
2020-10-16,2659,1599,895,19,575,4,106,210274,170562,0,
2020-10-17,2307,1386,820,25,430,6,105,212581,171948,0,
2020-10-18,2228,1379,804,13,459,12,91,214809,173327,0,
2020-10-19,2959,1887,1124,22,611,7,123,217768,175214,0,
2020-10-20,2827,1858,1101,27,569,9,152,220595,177072,0,
2020-10-21,2791,1744,1010,33,542,9,150,223386,178816,0,
2020-10-22,2797,1804,1095,21,559,2,127,226183,180620,0,
2020-10-23,2823,1817,1047,31,598,7,134,229006,182437,0,
2020-10-24,2643,1768,1038,34,534,10,152,231649,184205,0,
2020-10-25,2642,1688,1026,32,508,7,115,234291,185893,0,
2020-10-26,3385,2186,1271,23,689,10,193,237676,188079,0,
2020-10-27,3347,2232,1354,36,670,9,163,241023,190311,0,
2020-10-28,3624,2447,1434,38,768,9,198,244647,192758,0,
2020-10-29,3097,2003,1254,33,587,7,122,247744,194761,0,
2020-10-30,3526,2358,1336,44,814,10,154,251270,197119,0,
2020-10-31,3150,2167,1358,32,631,8,138,254420,199286,0,
2020-11-01,3450,2316,1386,33,741,8,148,257870,201602,0,
2020-11-02,4567,3065,1853,43,966,7,196,262437,204667,0,
2020-11-03,4493,3072,1807,34,939,15,277,266930,207739,0,
2020-11-04,4617,3092,1921,48,915,7,201,271547,210831,0,
2020-11-05,4537,3051,1763,34,964,8,282,276084,213882,0,
2020-11-06,4616,3097,1811,22,1006,11,247,280700,216979,0,
2020-11-07,4314,2873,1534,17,1102,9,211,285014,219852,0,
2020-11-08,4029,2676,1456,13,1024,8,175,289043,222528,0,
2020-11-09,5292,3570,1833,26,1450,14,247,294335,226098,0,
2020-11-10,5130,3441,1742,19,1432,14,234,299465,229539,0,
2020-11-11,4943,3428,1826,26,1352,9,215,304408,232967,0,
2020-11-12,5046,3587,1714,19,1609,12,233,309454,236554,0,
2020-11-13,5193,3736,1790,17,1684,16,229,314647,240290,0,
2020-11-14,4535,3419,1700,11,1518,13,177,319182,243709,0,
2020-11-15,4463,3326,1642,22,1496,18,148,323645,247035,0,
2020-11-16,5604,4113,2047,17,1851,21,177,329249,251148,0,
2020-11-17,5436,4019,1916,19,1820,14,250,334685,255167,0,
2020-11-18,5658,4218,2105,28,1875,12,198,340343,259385,0,
2020-11-19,5502,4000,1872,24,1876,16,212,345845,263385,0,
2020-11-20,5524,4164,1986,30,1923,15,210,351369,267549,0,
2020-11-21,5073,3812,1834,23,1771,15,169,356442,271361,0,
2020-11-22,4853,3549,1761,26,1563,22,177,361295,274910,0,
2020-11-23,6324,4609,2270,35,2046,16,242,367619,279519,0,
2020-11-24,6230,4632,2194,31,2132,11,264,373849,284151,0,
2020-11-25,6391,4711,2195,28,2157,15,316,380240,288862,0,
2020-11-26,6098,4569,2151,30,2173,17,198,386338,293431,0,
2020-11-27,6247,4558,2096,34,2192,18,218,392585,297989,0,
2020-11-28,5592,4098,1999,23,1781,15,280,398177,302087,0,
2020-11-29,5414,3871,1722,31,1869,15,234,403591,305958,0,
2020-11-30,6916,4958,2312,37,2315,21,273,410507,310916,0,
2020-12-01,6779,4836,2346,21,2203,7,259,417286,315752,0,
2020-12-02,6696,4830,2152,38,2366,13,261,423982,320582,0,
2020-12-03,6699,4729,2205,34,2181,17,292,430681,325311,0,
2020-12-04,6792,4836,2214,41,2295,10,276,437473,330147,0,
2020-12-05,5826,4109,1848,39,1959,12,251,443299,334256,0,
2020-12-06,5808,4023,1933,34,1764,31,261,449107,338279,0,
2020-12-07,7645,5317,2526,48,2370,26,347,456752,343596,0,
2020-12-08,7172,4922,2286,40,2216,17,363,463924,348518,0,
2020-12-09,6906,4766,2228,31,2111,19,377,470830,353284,0,
2020-12-10,6852,4668,2117,46,2132,24,349,477682,357952,0,
2020-12-11,6832,4715,2133,49,2155,22,356,484514,362667,0,
2020-12-12,6168,4090,1882,43,1820,24,321,490682,366757,0,
2020-12-13,5526,3669,1748,27,1595,16,283,496208,370426,0,
2020-12-14,7671,5094,2330,42,2223,29,470,503879,375520,0,
2020-12-15,7205,4791,2143,33,2167,17,431,511084,380311,0,
2020-12-16,6871,4574,2110,47,1977,9,431,517955,384885,0,
2020-12-17,6639,4335,1909,36,1943,27,420,524594,389220,0,
2020-12-18,6903,4537,2028,53,2003,20,433,531497,393757,0,
2020-12-19,5905,3735,1781,41,1591,17,305,537402,397492,0,
2020-12-20,5884,3768,1845,31,1568,20,304,543286,401260,0,
2020-12-21,7558,4706,2236,41,1940,16,473,550844,405966,0,
2020-12-22,7118,4394,2173,44,1734,22,421,557962,410360,0,
2020-12-23,7379,4620,2291,49,1803,30,447,565341,414980,0,
2020-12-24,6882,4422,2146,44,1806,14,412,572223,419402,0,
2020-12-25,5708,3518,1848,52,1327,15,276,577931,422920,0,
2020-12-26,7588,4998,2590,59,1976,25,348,585519,427918,0,
2020-12-27,7543,4949,2701,69,1786,20,373,593062,432867,0,
2020-12-28,8917,5766,3039,52,2193,25,457,601979,438633,0,
2020-12-29,8139,5301,2852,72,1909,16,452,610118,443934,0,
2020-12-30,7826,5014,2679,59,1770,40,466,617944,448948,0,
2020-12-31,7424,4937,2631,57,1803,15,431,625368,453885,0,
2021-01-01,6812,4472,2397,40,1645,28,362,632180,458357,0,
2021-01-02,7503,5094,2776,69,1770,44,435,639683,463451,0,
2021-01-03,7288,4737,2574,61,1664,48,390,646971,468188,0,
2021-01-04,8908,5833,3133,69,2043,32,556,655879,474021,0,
2021-01-05,7764,5139,2828,64,1718,48,481,663643,479160,0,
2021-01-06,7724,5011,2679,60,1660,53,559,671367,484171,0,
2021-01-07,6872,4457,2397,54,1475,38,493,678239,488628,0,
2021-01-08,6746,4440,2376,58,1472,39,495,684985,493068,0,
2021-01-09,5969,3882,2084,54,1299,40,405,690954,496950,0,
2021-01-10,5570,3677,1965,58,1246,29,379,696524,500627,0,
2021-01-11,6869,4596,2526,59,1474,37,500,703393,505223,0,
2021-01-12,6070,4031,2192,71,1289,30,449,709463,509254,0,
2021-01-13,6076,4029,2122,49,1344,32,482,715539,513283,0,
2021-01-14,5632,3830,2095,44,1218,28,445,721171,517113,0,
2021-01-15,6001,3899,2093,40,1336,30,400,727172,521012,0,
2021-01-16,4701,3169,1698,37,1122,20,292,731873,524181,0,
2021-01-17,4464,2984,1599,38,982,37,328,736337,527165,0,
2021-01-18,5646,3787,2018,40,1221,31,477,741983,530952,0,
2021-01-19,5207,3472,1846,48,1110,12,456,747190,534424,0,
2021-01-20,5033,3380,1852,56,1081,24,367,752223,537804,0,
2021-01-21,4755,3190,1711,30,1027,26,396,756978,540994,0,
2021-01-22,4495,3060,1679,39,1014,18,310,761473,544054,0,
2021-01-23,3938,2664,1448,43,872,15,286,765411,546718,0,
2021-01-24,3492,2346,1269,28,791,11,247,768903,549064,0,
2021-01-25,4615,3017,1623,37,946,18,393,773518,552081,0,
2021-01-26,4070,2654,1435,40,826,9,344,777588,554735,0,
2021-01-27,4153,2779,1531,28,885,15,320,781741,557514,0,
2021-01-28,3851,2500,1342,31,843,17,267,785592,560014,0,
2021-01-29,3742,2443,1308,40,851,14,230,789334,562457,0,
2021-01-30,3141,2081,1087,23,732,10,229,792475,564538,0,
2021-01-31,2856,1884,1066,24,602,18,174,795331,566422,0,
2021-02-01,4089,2695,1386,20,895,15,379,799420,569117,0,
2021-02-02,3609,2359,1286,33,779,11,250,803029,571476,0,
2021-02-03,3530,2295,1243,22,780,10,240,806559,573771,0,
2021-02-04,3347,2187,1177,26,727,14,243,809906,575958,0,
2021-02-05,3364,2210,1161,26,766,16,241,813270,578168,0,
2021-02-06,2785,1873,1046,18,671,7,131,816055,580041,0,
2021-02-07,2633,1739,974,24,592,12,137,818688,581780,0,
2021-02-08,3496,2282,1288,19,743,9,223,822184,584062,0,
2021-02-09,3223,2025,1125,29,681,13,177,825407,586087,0,
2021-02-10,3287,2183,1274,29,740,5,135,828694,588270,0,
2021-02-11,2885,1934,1169,24,599,7,135,831579,590204,0,
2021-02-12,3105,2066,1187,21,679,7,172,834684,592270,0,
2021-02-13,2670,1876,1125,17,575,4,155,837354,594146,0,
2021-02-14,2530,1708,1028,16,551,20,93,839884,595854,0,
2021-02-15,3038,2011,1215,33,630,7,126,842922,597865,0,
2021-02-16,3005,2097,1259,27,637,13,161,845927,599962,0,
2021-02-17,3089,2138,1302,29,628,8,171,849016,602100,0,
2021-02-18,3011,2113,1272,31,604,7,199,852027,604213,0,
2021-02-19,2994,2090,1239,24,656,5,166,855021,606303,0,
2021-02-20,2734,1887,1131,26,598,10,122,857755,608190,0,
2021-02-21,2526,1797,1049,14,599,10,125,860281,609987,0,
2021-02-22,3200,2225,1318,15,692,6,194,863481,612212,0,
2021-02-23,3016,2154,1311,11,675,4,153,866497,614366,0,
2021-02-24,3107,2159,1334,18,634,7,166,869604,616525,0,
2021-02-25,2838,2022,1231,16,621,4,150,872442,618547,0,
2021-02-26,2928,2102,1303,19,610,10,160,875370,620649,0,
2021-02-27,2701,2009,1225,11,605,14,154,878071,622658,0,
2021-02-28,2648,1962,1199,21,592,9,141,880719,624620,0,
2021-03-01,3507,2544,1497,19,807,7,214,884226,627164,0,
2021-03-02,3117,2294,1416,22,676,7,173,887343,629458,0,
2021-03-03,3289,2384,1480,19,714,15,156,890632,631842,0,
2021-03-04,2884,2180,1323,22,673,16,146,893516,634022,0,
2021-03-05,3211,2403,1519,21,692,4,167,896727,636425,0,
2021-03-06,2818,2122,1310,5,639,12,156,899545,638547,0,
2021-03-07,2696,2023,1211,13,661,9,129,902241,640570,0,
2021-03-08,3548,2680,1643,13,799,20,205,905789,643250,0,
2021-03-09,3359,2583,1593,24,751,11,204,909148,645833,0,
2021-03-10,3679,2811,1736,23,804,18,230,912827,648644,0,
2021-03-11,3290,2486,1528,15,724,18,201,916117,651130,0,
2021-03-12,3398,2623,1584,10,784,15,230,919515,653753,0,
2021-03-13,3165,2439,1541,10,719,10,159,922680,656192,0,
2021-03-14,3068,2299,1394,11,716,25,153,925748,658491,0,
2021-03-15,4158,3325,2021,12,1046,17,229,929906,661816,0,
2021-03-16,4004,3132,1948,11,937,13,223,933910,664948,0,
2021-03-17,4403,3540,2260,9,1034,21,216,938313,668488,0,
2021-03-18,4002,3192,2057,12,907,16,200,942315,671680,0,
2021-03-19,4346,3437,2097,12,1072,20,236,946661,675117,0,
2021-03-20,4184,3319,2018,12,1078,8,203,950845,678436,0,
2021-03-21,4200,3341,1984,17,1088,31,221,955045,681777,0,
2021-03-22,5333,4164,2481,20,1364,13,286,960378,685941,0,
2021-03-23,5569,4344,2517,24,1467,24,312,965947,690285,0,
2021-03-24,5613,4496,2721,21,1412,30,312,971560,694781,0,
2021-03-25,5226,4093,2422,17,1332,18,304,976786,698874,0,
2021-03-26,5687,4506,2664,22,1438,25,357,982473,703380,0,
2021-03-27,5377,4239,2508,22,1427,13,269,987850,707619,0,
2021-03-28,5434,4255,2510,17,1417,30,281,993284,711874,0,
2021-03-29,6674,5309,3115,14,1794,23,363,999958,717183,0,
2021-03-30,6739,5294,3138,21,1752,31,352,1006697,722477,0,
2021-03-31,6808,5436,3205,30,1829,19,353,1013505,727913,0,
2021-04-01,7860,6368,3576,37,2172,19,564,1021365,734281,0,
2021-04-02,7160,5712,3363,35,1850,18,446,1028525,739993,0,
2021-04-03,7162,5676,3355,32,1753,16,520,1035687,745669,0,
2021-04-04,7399,5897,3435,29,1939,22,472,1043086,751566,0,
2021-04-05,9591,7726,4405,39,2585,34,663,1052677,759292,0,
2021-04-06,9603,7754,4476,49,2496,25,708,1062280,767046,0,
2021-04-07,9627,7796,4496,43,2515,27,715,1071907,774842,0,
2021-04-08,8994,7284,4133,38,2344,22,747,1080901,782126,0,
2021-04-09,9028,7276,4007,41,2431,42,755,1089929,789402,0,
2021-04-10,8560,7029,3893,41,2350,32,713,1098489,796431,0,
2021-04-11,7823,6359,3515,32,2159,29,624,1106312,802790,0,
2021-04-12,9280,7514,4298,40,2349,36,791,1115592,810304,0,
2021-04-13,8655,7095,4019,32,2271,29,744,1124247,817399,0,
2021-04-14,8797,7232,4075,38,2237,34,848,1133044,824631,0,
2021-04-15,8080,6714,3829,29,2054,20,782,1141124,831345,0,
2021-04-16,8294,6938,3901,23,2297,28,689,1149418,838283,0,
2021-04-17,7888,6603,3760,36,2080,26,701,1157306,844886,0,
2021-04-18,7200,6075,3413,26,1972,34,630,1164506,850961,0,
2021-04-19,8759,7369,4164,36,2340,44,785,1173265,858330,0,
2021-04-20,8274,6995,4098,27,2169,32,669,1181539,865325,0,
2021-04-21,8198,7005,4073,28,2200,56,648,1189737,872330,0,
2021-04-22,7631,6498,3765,18,2069,58,588,1197368,878828,0,
2021-04-23,8072,6941,4000,33,2153,51,704,1205440,885769,0,
2021-04-24,7285,6158,3612,22,1937,23,564,1212725,891927,0,
2021-04-25,6758,5699,3374,21,1803,33,468,1219483,897626,0,
2021-04-26,8202,6963,4070,27,2170,45,651,1227685,904589,0,
2021-04-27,7640,6500,3886,21,1947,19,627,1235325,911089,0,
2021-04-28,8128,6901,4046,27,2111,20,697,1243453,917990,0,
2021-04-29,7120,6035,3600,24,1775,11,625,1250573,924025,0,
2021-04-30,7386,6310,3690,24,1885,37,674,1257959,930335,0,
2021-05-01,7038,6073,3578,18,1957,12,508,1264997,936408,0,
2021-05-02,6118,5263,3222,27,1566,12,436,1271115,941671,0,
2021-05-03,7522,6404,3872,26,2005,19,482,1278637,948075,0,
2021-05-04,6876,5809,3624,22,1748,25,390,1285513,953884,0,
2021-05-05,6753,5768,3547,27,1783,21,390,1292266,959652,0,
2021-05-06,6167,5180,3206,11,1572,14,377,1298433,964832,0,
2021-05-07,6289,5284,3274,19,1630,22,339,1304722,970116,0,
2021-05-08,5617,4749,2940,25,1488,10,286,1310339,974865,0,
2021-05-09,5013,4241,2687,20,1317,5,212,1315352,979106,0,
2021-05-10,6306,5253,3190,26,1658,19,360,1321658,984359,0,
2021-05-11,5488,4563,2803,26,1405,6,323,1327146,988922,0,
2021-05-12,5445,4553,2819,19,1448,6,261,1332591,993475,0,
2021-05-13,4963,4122,2596,19,1259,12,236,1337554,997597,0,
2021-05-14,4892,4061,2459,11,1304,10,277,1342446,1001658,0,
2021-05-15,4297,3557,2172,9,1140,9,227,1346743,1005215,0,
2021-05-16,3802,3135,1886,6,1061,11,171,1350545,1008350,0,
2021-05-17,4528,3716,2239,9,1151,13,304,1355073,1012066,0,
2021-05-18,4086,3302,1972,11,1047,7,265,1359159,1015368,0,
2021-05-19,3700,3006,1852,14,944,4,192,1362859,1018374,0,
2021-05-20,3472,2827,1704,8,868,7,240,1366331,1021201,0,
2021-05-21,3262,2642,1604,7,809,7,215,1369593,1023843,0,
2021-05-22,2649,2175,1326,8,703,4,134,1372242,1026018,0,
2021-05-23,2317,1862,1120,1,624,3,114,1374559,1027880,0,
2021-05-24,2415,1945,1176,6,644,2,117,1376974,1029825,0,
2021-05-25,2689,2157,1363,1,652,5,136,1379663,1031982,0,
2021-05-26,2406,1930,1228,7,587,4,104,1382069,1033912,0,
2021-05-27,2236,1812,1176,6,533,5,92,1384305,1035724,0,
2021-05-28,2092,1688,1093,8,495,4,88,1386397,1037412,0,
2021-05-29,1685,1350,841,1,428,7,73,1388082,1038762,0,
2021-05-30,1544,1247,807,6,377,7,50,1389626,1040009,0,
2021-05-31,1971,1590,1055,1,456,6,72,1391597,1041599,0,
2021-06-01,1847,1516,945,8,469,8,86,1393444,1043115,0,
2021-06-02,1730,1391,913,3,416,2,57,1395174,1044506,0,
2021-06-03,1499,1221,803,5,346,4,63,1396673,1045727,0,
2021-06-04,1489,1174,753,3,348,5,65,1398162,1046901,0,
2021-06-05,1226,999,651,3,297,5,43,1399388,1047900,0,
2021-06-06,1096,874,577,0,259,3,35,1400484,1048774,0,
2021-06-07,1445,1144,767,3,318,5,51,1401929,1049918,0,
2021-06-08,1208,954,598,2,292,8,54,1403137,1050872,0,
2021-06-09,1202,959,648,6,232,6,67,1404339,1051831,0,
2021-06-10,1185,924,643,6,213,9,53,1405524,1052755,0,
2021-06-11,1056,817,526,1,228,9,53,1406580,1053572,0,
2021-06-12,911,715,458,4,187,9,57,1407491,1054287,0,
2021-06-13,769,612,378,2,185,3,44,1408260,1054899,0,
2021-06-14,1040,790,518,3,220,12,37,1409300,1055689,0,
2021-06-15,912,696,474,0,189,6,27,1410212,1056385,0,
2021-06-16,854,650,431,1,166,11,41,1411066,1057035,0,
2021-06-17,712,545,368,2,144,6,25,1411778,1057580,0,
2021-06-18,723,569,373,3,146,16,31,1412501,1058149,0,
2021-06-19,569,453,267,0,142,6,38,1413070,1058602,0,
2021-06-20,567,425,255,3,134,5,28,1413637,1059027,0,
2021-06-21,697,552,333,1,164,9,45,1414334,1059579,0,
2021-06-22,664,503,307,2,146,6,42,1414998,1060082,0,
2021-06-23,665,495,316,1,143,4,31,1415663,1060577,0,
2021-06-24,582,454,274,4,132,11,33,1416245,1061031,0,
2021-06-25,537,417,262,3,113,6,33,1416782,1061448,0,
2021-06-26,472,354,212,3,110,7,22,1417254,1061802,0,
2021-06-27,431,319,184,1,99,4,31,1417685,1062121,0,
2021-06-28,551,414,243,1,122,9,39,1418236,1062535,0,
2021-06-29,488,350,174,2,117,12,45,1418724,1062885,0,
2021-06-30,480,386,217,4,109,11,45,1419204,1063271,0,
2021-07-01,410,294,167,3,93,11,20,1419614,1063565,0,
2021-07-02,435,319,173,0,102,4,40,1420049,1063884,0,
2021-07-03,430,333,183,2,116,12,20,1420479,1064217,0,
2021-07-04,403,301,161,2,113,3,22,1420882,1064518,0,
2021-07-05,524,365,213,3,119,5,25,1421406,1064883,0,
2021-07-06,490,359,211,4,117,9,18,1421896,1065242,0,
2021-07-07,418,310,172,4,108,10,16,1422314,1065552,0,
2021-07-08,354,253,140,3,87,9,14,1422668,1065805,0,
2021-07-09,379,273,135,2,99,13,24,1423047,1066078,,
2021-07-10,353,265,141,2,100,13,9,1423400,1066343,,
2021-07-11,339,245,127,0,91,12,15,1423739,1066588,,
2021-07-12,468,363,191,1,140,12,19,1424207,1066951,,
2021-07-13,436,312,160,0,119,8,25,1424643,1067263,,
2021-07-14,487,337,177,0,122,17,21,1425130,1067600,,
2021-07-15,427,307,157,1,117,16,16,1425557,1067907,,
2021-07-16,471,351,183,6,126,16,20,1426028,1068258,,
2021-07-17,406,303,157,7,116,14,9,1426434,1068561,,
2021-07-18,493,358,174,7,145,16,16,1426927,1068919,,
2021-07-19,618,467,226,4,207,16,14,1427545,1069386,,
2021-07-20,699,525,259,10,231,12,13,1428244,1069911,,
2021-07-21,680,512,242,5,236,18,11,1428924,1070423,,
2021-07-22,621,454,232,9,186,14,13,1429545,1070877,,
2021-07-23,675,525,272,4,199,16,34,1430220,1071402,,
2021-07-24,638,496,290,4,177,14,11,1430858,1071898,,
2021-07-25,745,576,296,11,237,18,14,1431603,1072474,,
2021-07-26,1027,797,408,7,334,24,24,1432630,1073271,,
2021-07-27,970,744,408,10,292,11,23,1433600,1074015,,
2021-07-28,967,724,381,10,284,25,24,1434567,1074739,,
2021-07-29,946,698,364,11,285,20,18,1435513,1075437,,
2021-07-30,954,692,370,12,264,17,29,1436467,1076129,,
2021-07-31,982,760,374,9,327,24,26,1437449,1076889,,
2021-08-01,1188,901,479,18,355,24,25,1438637,1077790,,
2021-08-02,1532,1078,490,20,507,27,34,1440169,1078868,,
2021-08-03,1764,1285,631,17,549,28,60,1441933,1080153,,
2021-08-04,1728,1248,604,21,555,18,50,1443661,1081401,,
2021-08-05,1692,1181,612,15,498,23,33,1445353,1082582,,
2021-08-06,1651,1110,539,14,485,21,51,1447004,1083692,,
2021-08-07,1693,1249,632,11,536,25,45,1448697,1084941,,
2021-08-08,1769,1296,668,23,542,20,43,1450466,1086237,,
2021-08-09,2221,1624,819,23,701,20,61,1452687,1087861,,
2021-08-10,2417,1789,855,27,793,40,74,1455104,1089650,,
2021-08-11,2335,1717,832,29,768,24,64,1457439,1091367,,
2021-08-12,2106,1544,763,27,668,35,51,1459545,1092911,,
2021-08-13,2129,1551,786,15,650,38,62,1461674,1094462,,
2021-08-14,2178,1638,841,25,687,27,58,1463852,1096100,,
2021-08-15,2257,1663,852,23,722,16,50,1466109,1097763,,
2021-08-16,3021,2256,1067,31,1051,31,76,1469130,1100019,,
2021-08-17,2984,2193,1071,30,986,28,78,1472114,1102212,,
2021-08-18,2975,2188,1047,33,1004,22,82,1475089,1104400,,
2021-08-19,2732,1985,967,17,904,27,70,1477821,1106385,,
2021-08-20,2854,2153,1014,22,1018,19,80,1480675,1108538,,
2021-08-21,2729,2098,950,15,1030,23,80,1483404,1110636,,
2021-08-22,2919,2220,939,21,1172,24,64,1486323,1112856,,
2021-08-23,3721,2755,1061,13,1555,30,96,1490044,1115611,,
2021-08-24,3753,2776,1034,8,1614,29,91,1493797,1118387,,
2021-08-25,3723,2722,975,7,1638,17,85,1497520,1121109,,
2021-08-26,3361,2478,948,5,1427,19,79,1500881,1123587,,
2021-08-27,3627,2623,911,6,1576,18,112,1504508,1126210,,
2021-08-28,3286,2460,912,8,1442,26,72,1507794,1128670,,
2021-08-29,3247,2418,838,6,1477,21,76,1511041,1131088,,
2021-08-30,4072,2922,1028,11,1776,22,85,1515113,1134010,,
2021-08-31,4038,2877,933,10,1832,16,86,1519151,1136887,,
2021-09-01,4442,3201,1087,6,1993,19,96,1523593,1140088,,
2021-09-02,3881,2811,998,4,1718,14,77,1527474,1142899,,
2021-09-03,4156,3035,1054,7,1856,24,94,1531630,1145934,,
2021-09-04,3632,2719,925,6,1722,17,49,1535262,1148653,,
2021-09-05,3568,2614,861,5,1684,9,55,1538830,1151267,,
2021-09-06,4006,2951,974,8,1878,10,81,1542836,1154218,,
2021-09-07,4836,3428,1174,4,2130,10,110,1547672,1157646,,
2021-09-08,4792,3368,1138,6,2124,16,84,1552464,1161014,,
2021-09-09,4409,3077,1038,6,1928,23,82,1556873,1164091,,
2021-09-10,4488,3170,1062,10,2025,10,63,1561361,1167261,,
2021-09-11,3764,2746,923,5,1734,10,74,1565125,1170007,,
2021-09-12,3707,2693,931,4,1674,11,73,1568832,1172700,,
2021-09-13,4928,3404,1154,6,2147,13,84,1573760,1176104,,
2021-09-14,4551,3209,1093,8,1978,22,108,1578311,1179313,,
2021-09-15,4593,3232,1145,7,1966,14,100,1582904,1182545,,
2021-09-16,4318,3078,1126,1,1854,8,89,1587222,1185623,,
2021-09-17,4455,3112,1115,3,1880,6,108,1591677,1188735,,
2021-09-18,3812,2782,1016,3,1670,15,78,1595489,1191517,,
2021-09-19,3657,2732,932,12,1706,8,74,1599146,1194249,,
2021-09-20,4891,3574,1298,4,2152,13,107,1604037,1197823,,
2021-09-21,4538,3273,1167,5,1999,11,91,1608575,1201096,,
2021-09-22,4309,3216,1217,7,1899,10,83,1612884,1204312,,
2021-09-23,4114,2998,1177,4,1731,17,69,1616998,1207310,,
2021-09-24,4199,3141,1161,8,1854,7,111,1621197,1210451,,
2021-09-25,3468,2659,989,3,1596,6,65,1624665,1213110,,
2021-09-26,3574,2737,1031,6,1624,12,64,1628239,1215847,,
2021-09-27,4394,3186,1213,7,1867,12,87,1632633,1219033,,
2021-09-28,3778,2722,1069,7,1558,14,74,1636411,1221755,,
2021-09-29,3886,2836,1140,3,1605,18,70,1640297,1224591,,
2021-09-30,3264,2461,943,3,1450,9,56,1643561,1227052,,
2021-10-01,3631,2597,1019,0,1492,13,73,1647192,1229649,,
2021-10-02,2922,2162,886,2,1210,10,54,1650114,1231811,,
2021-10-03,2835,2039,860,4,1106,15,54,1652949,1233850,,
2021-10-04,3712,2582,1034,6,1459,14,69,1656661,1236432,,
2021-10-05,3418,2340,985,4,1270,8,73,1660079,1238772,,
2021-10-06,3233,2240,979,4,1195,5,57,1663312,1241012,,
2021-10-07,2923,1990,854,3,1050,8,75,1666235,1243002,,
2021-10-08,3077,2090,839,5,1169,11,66,1669312,1245092,,
2021-10-09,2630,1839,781,2,994,9,53,1671942,1246931,,
2021-10-10,2360,1707,732,2,915,9,49,1674302,1248638,,
2021-10-11,2586,1789,751,2,970,15,51,1676888,1250427,,
2021-10-12,3047,2060,860,2,1113,14,71,1679935,1252487,,
2021-10-13,2948,1967,889,0,1018,12,48,1682883,1254454,,
2021-10-14,2674,1833,772,4,996,11,50,1685557,1256287,,
2021-10-15,2589,1797,753,2,973,10,59,1688146,1258084,,
2021-10-16,2191,1601,693,0,859,10,39,1690337,1259685,,
2021-10-17,2100,1522,652,2,811,10,47,1692437,1261207,,
2021-10-18,2611,1832,812,1,947,14,58,1695048,1263039,,
2021-10-19,2300,1570,680,2,823,13,52,1697348,1264609,,
2021-10-20,2411,1666,739,4,858,7,58,1699759,1266275,,
2021-10-21,2230,1513,704,0,740,10,59,1701989,1267788,,
2021-10-22,2229,1589,692,4,831,4,58,1704218,1269377,,
2021-10-23,1844,1301,569,2,671,5,54,1706062,1270678,,
2021-10-24,1949,1400,598,2,744,9,47,1708011,1272078,,
2021-10-25,2458,1695,770,2,855,21,47,1710469,1273773,,
2021-10-26,2266,1570,718,1,768,17,66,1712735,1275343,,
2021-10-27,2272,1550,710,3,774,12,51,1715007,1276893,,
2021-10-28,2204,1479,686,1,719,9,64,1717211,1278372,,
2021-10-29,2191,1388,619,5,691,7,66,1719402,1279760,,
2021-10-30,1980,1328,616,1,646,16,49,1721382,1281088,,
2021-10-31,2018,1388,666,0,639,13,70,1723400,1282476,,
2021-11-01,2797,1943,865,4,960,11,103,1726197,1284419,,
2021-11-02,2661,1858,888,2,875,16,77,1728858,1286277,,
2021-11-03,2587,1882,870,1,880,22,109,1731445,1288159,,
2021-11-04,2508,1753,865,5,781,13,89,1733953,1289912,,
2021-11-05,2549,1758,859,3,784,16,96,1736502,1291670,,
2021-11-06,2329,1656,826,3,723,22,82,1738831,1293326,,
2021-11-07,2120,1435,707,2,627,14,85,1740951,1294761,,
2021-11-08,2727,1781,889,13,768,23,88,1743678,1296542,,
2021-11-09,2503,1619,869,7,640,20,83,1746181,1298161,,
2021-11-10,2593,1753,892,6,722,13,120,1748774,1299914,,
2021-11-11,2185,1462,730,2,633,20,77,1750959,1301376,,
2021-11-12,2407,1577,833,8,620,15,101,1753366,1302953,,
2021-11-13,2120,1454,787,4,579,10,74,1755486,1304407,,
2021-11-14,2146,1425,708,3,633,24,57,1757632,1305832,,
2021-11-15,2655,1735,947,4,686,15,83,1760287,1307567,,
2021-11-16,2519,1642,847,5,633,31,126,1762806,1309209,,
2021-11-17,2667,1741,879,1,716,31,114,1765473,1310950,,
2021-11-18,2376,1498,814,3,558,22,101,1767849,1312448,,
2021-11-19,2542,1618,811,3,657,25,122,1770391,1314066,,
2021-11-20,2244,1357,712,5,513,30,97,1772635,1315423,,
2021-11-21,2362,1465,777,5,578,18,87,1774997,1316888,,
2021-11-22,3068,1871,1005,2,704,29,131,1778065,1318759,,
2021-11-23,2858,1758,970,2,638,33,115,1780923,1320517,,
2021-11-24,2882,1749,939,6,645,23,136,1783805,1322266,,
2021-11-25,2595,1570,854,0,591,29,96,1786400,1323836,,
2021-11-26,2823,1674,867,5,614,22,166,1789223,1325510,,
2021-11-27,2495,1557,841,1,554,35,126,1791718,1327067,,
2021-11-28,2630,1571,834,1,561,44,131,1794348,1328638,,
2021-11-29,3320,1945,1000,2,726,63,154,1797668,1330583,,
2021-11-30,3192,1825,946,2,693,34,150,1800860,1332408,,
2021-12-01,3541,1997,1086,4,681,35,191,1804401,1334405,,
2021-12-02,3271,1869,941,4,668,39,217,1807672,1336274,,
2021-12-03,3621,2106,1075,5,730,37,259,1811293,1338380,,
2021-12-04,3039,1696,878,4,609,39,166,1814332,1340076,,
2021-12-05,3323,1919,1004,6,669,43,197,1817655,1341995,,
2021-12-06,4501,2574,1369,7,842,44,312,1822156,1344569,,
2021-12-07,4608,2619,1420,5,784,50,360,1826764,1347188,,
2021-12-08,4677,2740,1424,6,843,43,424,1831441,1349928,,
2021-12-09,4456,2489,1232,8,746,50,453,1835897,1352417,,
2021-12-10,4805,2810,1343,6,761,64,636,1840702,1355227,,
2021-12-11,4713,2829,1182,12,837,67,731,1845415,1358056,,
2021-12-12,5611,3426,1265,9,983,73,1096,1851026,1361482,,
2021-12-13,8486,5098,1629,7,1322,114,2026,1859512,1366580,,
2021-12-14,8694,5117,1546,16,1251,88,2216,1868206,1371697,,
2021-12-15,8511,4838,1285,20,988,64,2481,1876717,1376535,,
2021-12-16,8133,4541,1103,11,721,57,2649,1884850,1381076,,
2021-12-17,7916,4684,918,5,668,52,3041,1892766,1385760,,
2021-12-18,6110,3860,608,2,375,24,2851,1898876,1389620,,
2021-12-19,5633,3523,356,0,200,13,2954,1904509,1393143,,
2021-12-20,6597,5034,245,0,139,6,4644,1911106,1398177,,
2021-12-21,4164,3709,78,0,43,2,3586,1915270,1401886,,
2021-12-22,1727,1635,25,0,9,0,1601,1916997,1403521,,
2021-12-23,75,75,1,0,0,0,74,1917072,1403596,,