date,new,NTotal_ExposureOnly,domestic-contactWithCase,domestic-contactWithTraveller,domestic-unknown,internationalTravel,infopending,cumulative,cumulativeNTotal_ExposureOnly,doubleFlagTest,shaded
2020-01-15,2,1,0,0,0,1,0,2,1,1,14
2020-01-16,5,3,1,0,2,0,0,7,4,1,
2020-01-17,1,1,0,0,0,1,0,8,5,0,
2020-01-18,0,0,0,0,0,0,0,8,5,0,
2020-01-19,0,0,0,0,0,0,0,8,5,0,
2020-01-20,1,0,0,0,0,0,0,9,5,0,
2020-01-21,4,0,0,0,0,0,0,13,5,0,
2020-01-22,5,4,1,0,1,2,0,18,9,1,
2020-01-23,0,0,0,0,0,0,0,18,9,0,
2020-01-24,3,2,0,0,0,2,0,21,11,0,
2020-01-25,4,3,2,0,1,0,0,25,14,0,
2020-01-26,2,1,1,0,0,0,0,27,15,0,
2020-01-27,7,3,2,0,1,0,0,34,18,0,
2020-01-28,6,2,1,0,0,1,0,40,20,1,
2020-01-29,2,1,0,0,0,0,1,42,21,0,
2020-01-30,2,1,1,0,0,0,0,44,22,0,
2020-01-31,2,1,0,0,1,0,0,46,23,0,
2020-02-01,5,5,3,0,1,1,0,51,28,0,
2020-02-02,3,2,0,0,1,1,0,54,30,0,
2020-02-03,1,1,0,0,1,0,0,55,31,0,
2020-02-04,2,2,0,0,2,0,0,57,33,0,
2020-02-05,3,3,1,0,1,1,0,60,36,0,
2020-02-06,0,0,0,0,0,0,0,60,36,0,
2020-02-07,0,0,0,0,0,0,0,60,36,0,
2020-02-08,1,0,0,0,0,0,0,61,36,0,
2020-02-09,1,1,0,0,0,1,0,62,37,0,
2020-02-10,2,2,0,0,1,1,0,64,39,0,
2020-02-11,2,1,0,0,1,0,0,66,40,0,
2020-02-12,4,3,2,0,1,0,0,70,43,0,
2020-02-13,1,1,0,0,0,1,0,71,44,0,
2020-02-14,6,5,0,0,3,2,0,77,49,0,
2020-02-15,3,2,1,0,0,1,0,80,51,1,
2020-02-16,1,1,0,0,0,1,0,81,52,0,
2020-02-17,2,2,1,0,0,1,0,83,54,0,
2020-02-18,2,2,2,0,0,0,0,85,56,0,
2020-02-19,4,4,2,0,1,1,0,89,60,0,
2020-02-20,9,9,3,1,3,2,0,98,69,0,
2020-02-21,3,3,0,0,1,2,0,101,72,0,
2020-02-22,8,8,2,0,3,3,0,109,80,0,
2020-02-23,22,22,11,0,3,7,1,131,102,0,
2020-02-24,15,14,3,0,2,9,0,146,116,0,
2020-02-25,16,16,4,0,2,10,0,162,132,1,
2020-02-26,14,13,6,1,4,2,0,176,145,0,
2020-02-27,27,26,12,0,7,7,0,203,171,0,
2020-02-28,39,37,17,0,6,14,0,242,208,0,
2020-02-29,27,27,8,0,7,12,0,269,235,0,
2020-03-01,60,59,12,0,26,20,1,329,294,1,
2020-03-02,56,56,8,0,18,30,0,385,350,0,
2020-03-03,55,55,15,0,12,28,0,440,405,0,
2020-03-04,61,58,13,1,14,30,0,501,463,0,
2020-03-05,67,67,12,1,23,31,0,568,530,0,
2020-03-06,86,85,17,2,26,40,0,654,615,0,
2020-03-07,91,91,14,3,30,44,0,745,706,1,
2020-03-08,135,134,27,2,45,60,0,880,840,0,
2020-03-09,224,223,44,10,79,90,0,1104,1063,0,
2020-03-10,256,254,55,9,72,118,0,1360,1317,0,
2020-03-11,295,295,74,11,84,125,1,1655,1612,1,
2020-03-12,389,389,92,9,128,159,1,2044,2001,0,
2020-03-13,467,461,125,8,151,175,2,2511,2462,0,
2020-03-14,469,466,98,15,168,183,2,2980,2928,0,
2020-03-15,605,601,152,10,212,225,2,3585,3529,1,
2020-03-16,848,840,254,10,308,267,1,4433,4369,0,
2020-03-17,870,865,260,16,320,264,5,5303,5234,0,
2020-03-18,970,964,281,19,358,302,4,6273,6198,0,
2020-03-19,811,802,253,13,297,236,3,7084,7000,0,
2020-03-20,1060,1055,364,21,423,238,9,8144,8055,1,
2020-03-21,909,895,320,8,326,237,4,9053,8950,0,
2020-03-22,871,861,320,13,341,185,2,9924,9811,0,
2020-03-23,1093,1080,465,16,417,173,9,11017,10891,0,
2020-03-24,996,986,398,21,390,173,4,12013,11877,0,
2020-03-25,1007,992,450,13,414,108,7,13020,12869,0,
2020-03-26,940,929,449,12,342,117,9,13960,13798,0,
2020-03-27,972,962,483,8,374,84,13,14932,14760,0,
2020-03-28,976,966,472,9,390,84,11,15908,15726,0,
2020-03-29,887,879,461,7,355,50,6,16795,16605,1,
2020-03-30,1180,1172,584,10,488,77,13,17975,17777,0,
2020-03-31,1007,1000,559,3,357,68,13,18982,18777,0,
2020-04-01,1325,1314,756,12,453,84,9,20307,20091,0,
2020-04-02,1194,1188,748,11,375,46,8,21501,21279,0,
2020-04-03,1340,1330,887,6,375,53,9,22841,22609,0,
2020-04-04,1173,1170,744,9,371,29,17,24014,23779,0,
2020-04-05,1080,1075,679,5,370,13,8,25094,24854,0,
2020-04-06,1442,1438,886,11,514,14,13,26536,26292,0,
2020-04-07,1308,1303,792,13,469,16,13,27844,27595,0,
2020-04-08,1407,1403,884,10,489,6,14,29251,28998,0,
2020-04-09,1506,1504,968,14,494,4,24,30757,30502,0,
2020-04-10,1810,1805,1136,19,620,6,24,32567,32307,0,
2020-04-11,1716,1713,973,11,686,4,39,34283,34020,1,
2020-04-12,1447,1444,888,16,506,7,27,35730,35464,0,
2020-04-13,2129,2127,1169,33,887,6,32,37859,37591,0,
2020-04-14,1820,1819,1095,21,668,2,33,39679,39410,0,
2020-04-15,1964,1957,1233,22,673,4,25,41643,41367,0,
2020-04-16,1962,1958,1105,19,778,1,55,43605,43325,0,
2020-04-17,1861,1857,1105,17,698,3,34,45466,45182,0,
2020-04-18,1620,1615,1042,20,523,3,27,47086,46797,0,
2020-04-19,1231,1227,742,15,455,4,11,48317,48024,0,
2020-04-20,1845,1841,1080,10,714,2,35,50162,49865,0,
2020-04-21,1412,1410,842,13,520,6,29,51574,51275,0,
2020-04-22,1571,1566,909,13,613,1,30,53145,52841,0,
2020-04-23,1582,1571,916,18,600,5,32,54727,54412,0,
2020-04-24,1539,1534,930,11,548,2,43,56266,55946,0,
2020-04-25,1406,1399,822,14,476,5,82,57672,57345,0,
2020-04-26,1317,1312,788,13,465,4,42,58989,58657,0,
2020-04-27,1657,1646,949,12,640,5,40,60646,60303,0,
2020-04-28,1531,1520,928,18,545,6,23,62177,61823,0,
2020-04-29,1488,1482,806,4,655,2,15,63665,63305,0,
2020-04-30,1471,1463,828,4,611,3,17,65136,64768,0,
2020-05-01,1593,1582,895,8,656,4,19,66729,66350,0,
2020-05-02,1070,1066,657,8,381,0,20,67799,67416,0,
2020-05-03,1023,1021,621,6,379,5,10,68822,68437,1,
2020-05-04,1363,1357,775,6,553,2,21,70185,69794,0,
2020-05-05,1301,1295,727,6,535,1,26,71486,71089,0,
2020-05-06,1127,1123,661,8,434,2,18,72613,72212,0,
2020-05-07,1180,1173,712,4,432,6,19,73793,73385,0,
2020-05-08,1183,1178,701,7,454,1,15,74976,74563,0,
2020-05-09,1023,1017,634,8,353,4,18,75999,75580,0,
2020-05-10,919,916,541,7,352,5,11,76918,76496,0,
2020-05-11,1225,1223,726,8,451,7,31,78143,77719,0,
2020-05-12,1164,1155,716,2,411,6,20,79307,78874,0,
2020-05-13,1103,1093,646,3,425,3,16,80410,79967,0,
2020-05-14,1160,1159,684,3,453,5,14,81570,81126,0,
2020-05-15,1217,1214,711,0,479,11,13,82787,82340,0,
2020-05-16,1001,993,601,2,375,2,13,83788,83333,0,
2020-05-17,913,903,537,2,344,8,12,84701,84236,0,
2020-05-18,1090,1080,617,2,449,5,7,85791,85316,0,
2020-05-19,963,959,583,3,361,4,8,86754,86275,0,
2020-05-20,1122,1109,651,2,444,1,11,87876,87384,0,
2020-05-21,884,873,547,2,307,6,11,88760,88257,0,
2020-05-22,841,831,513,0,311,5,2,89601,89088,0,
2020-05-23,690,684,441,1,232,4,6,90291,89772,0,
2020-05-24,651,646,400,0,231,4,11,90942,90418,0,
2020-05-25,857,845,508,3,313,4,17,91799,91263,0,
2020-05-26,747,733,458,1,261,7,6,92546,91996,0,
2020-05-27,714,702,425,2,263,2,10,93260,92698,0,
2020-05-28,596,582,361,2,205,2,12,93856,93280,0,
2020-05-29,731,727,444,0,275,3,5,94587,94007,0,
2020-05-30,563,556,397,2,154,1,2,95150,94563,0,
2020-05-31,408,398,258,0,131,3,6,95558,94961,0,
2020-06-01,687,679,395,6,249,6,23,96245,95640,0,
2020-06-02,493,485,320,1,155,5,4,96738,96125,0,
2020-06-03,491,487,321,4,149,4,9,97229,96612,0,
2020-06-04,461,452,265,1,169,11,6,97690,97064,0,
2020-06-05,445,435,311,0,118,3,3,98135,97499,0,
2020-06-06,371,366,234,1,124,4,3,98506,97865,0,
2020-06-07,314,302,212,0,84,1,5,98820,98167,0,
2020-06-08,432,424,289,6,114,10,5,99252,98591,0,
2020-06-09,373,366,244,3,110,4,5,99625,98957,0,
2020-06-10,440,435,259,5,152,10,9,100065,99392,0,
2020-06-11,376,360,242,3,107,5,3,100441,99752,0,
2020-06-12,375,370,224,5,132,6,3,100816,100122,0,
2020-06-13,274,270,180,1,83,5,1,101090,100392,0,
2020-06-14,300,293,186,0,95,9,3,101390,100685,0,
2020-06-15,398,391,242,4,134,7,4,101788,101076,0,
2020-06-16,368,357,234,2,106,10,5,102156,101433,0,
2020-06-17,363,355,228,0,117,6,4,102519,101788,0,
2020-06-18,328,317,198,1,110,4,4,102847,102105,0,
2020-06-19,335,334,231,0,88,11,4,103182,102439,0,
2020-06-20,285,279,186,0,84,8,1,103467,102718,0,
2020-06-21,270,267,175,0,85,4,3,103737,102985,0,
2020-06-22,323,317,211,2,96,4,4,104060,103302,0,
2020-06-23,325,325,219,2,91,6,7,104385,103627,0,
2020-06-24,285,285,183,2,87,9,4,104670,103912,0,
2020-06-25,463,461,326,2,122,5,6,105133,104373,0,
2020-06-26,277,270,170,0,83,11,6,105410,104643,0,
2020-06-27,251,247,165,1,71,7,3,105661,104890,0,
2020-06-28,237,234,135,1,88,9,1,105898,105124,0,
2020-06-29,332,327,198,2,106,10,11,106230,105451,0,
2020-06-30,310,299,197,4,93,2,3,106540,105750,0,
2020-07-01,287,274,177,8,83,5,1,106827,106024,0,
2020-07-02,266,258,161,1,83,6,7,107093,106282,0,
2020-07-03,305,293,184,2,91,13,3,107398,106575,0,
2020-07-04,292,280,173,3,93,10,1,107690,106855,0,
2020-07-05,271,268,177,3,81,6,1,107961,107123,0,
2020-07-06,502,491,269,2,175,17,28,108463,107614,0,
2020-07-07,519,507,264,6,208,19,10,108982,108121,0,
2020-07-08,439,419,279,4,121,10,5,109421,108540,0,
2020-07-09,449,431,268,3,139,12,9,109870,108971,0,
2020-07-10,412,389,258,5,107,14,5,110282,109360,0,
2020-07-11,384,373,228,3,128,12,2,110666,109733,0,
2020-07-12,396,381,236,3,134,6,2,111062,110114,0,
2020-07-13,604,571,359,12,185,12,3,111666,110685,0,
2020-07-14,544,505,299,4,182,13,7,112210,111190,0,
2020-07-15,564,519,310,3,175,16,15,112774,111709,0,
2020-07-16,457,419,259,4,136,17,3,113231,112128,0,
2020-07-17,500,463,272,6,167,7,11,113731,112591,0,
2020-07-18,405,381,228,2,137,7,7,114136,112972,0,
2020-07-19,392,357,202,4,137,12,2,114528,113329,0,
2020-07-20,526,472,264,6,183,14,5,115054,113801,0,
2020-07-21,523,469,267,10,181,6,5,115577,114270,0,
2020-07-22,443,381,181,6,180,10,4,116020,114651,0,
2020-07-23,445,355,173,3,166,7,6,116465,115006,0,
2020-07-24,457,377,180,7,178,5,7,116922,115383,0,
2020-07-25,307,230,108,4,109,6,3,117229,115613,0,
2020-07-26,333,220,102,6,100,10,2,117562,115833,0,
2020-07-27,471,330,176,3,133,14,4,118033,116163,0,
2020-07-28,415,285,154,1,111,14,5,118448,116448,0,
2020-07-29,403,245,138,1,99,3,4,118851,116693,0,
2020-07-30,330,213,109,1,87,6,10,119181,116906,0,
2020-07-31,339,221,120,0,86,10,5,119520,117127,0,
2020-08-01,337,207,113,8,61,17,8,119857,117334,0,
2020-08-02,330,196,123,6,59,6,2,120187,117530,0,
2020-08-03,427,272,162,2,97,10,1,120614,117802,0,
2020-08-04,445,313,186,0,100,20,7,121059,118115,0,
2020-08-05,376,277,170,9,87,8,3,121435,118392,0,
2020-08-06,344,248,161,4,71,7,5,121779,118640,0,
2020-08-07,383,300,189,2,91,6,12,122162,118940,0,
2020-08-08,333,238,151,4,77,2,4,122495,119178,0,
2020-08-09,322,254,150,7,87,7,3,122817,119432,0,
2020-08-10,470,365,215,8,124,12,6,123287,119797,0,
2020-08-11,469,356,217,5,123,10,1,123756,120153,0,
2020-08-12,405,324,211,11,87,12,3,124161,120477,0,
2020-08-13,420,349,221,8,108,10,2,124581,120826,0,
2020-08-14,374,302,175,7,108,9,3,124955,121128,0,
2020-08-15,365,302,171,7,111,7,6,125320,121430,0,
2020-08-16,377,292,167,14,104,4,3,125697,121722,0,
2020-08-17,539,413,263,11,125,7,7,126236,122135,0,
2020-08-18,424,348,205,4,123,4,12,126660,122483,0,
2020-08-19,445,351,207,9,120,5,10,127105,122834,0,
2020-08-20,440,351,222,5,107,4,13,127545,123185,0,
2020-08-21,421,334,206,9,105,5,9,127966,123519,0,
2020-08-22,394,333,225,7,93,5,3,128360,123852,0,
2020-08-23,402,316,203,3,103,6,1,128762,124168,0,
2020-08-24,571,434,266,15,137,7,9,129333,124602,0,
2020-08-25,611,454,293,12,138,10,1,129944,125056,0,
2020-08-26,610,452,286,13,143,5,5,130554,125508,0,
2020-08-27,484,363,230,11,109,3,10,131038,125871,0,
2020-08-28,556,413,262,11,126,6,8,131594,126284,0,
2020-08-29,455,327,205,10,89,5,18,132049,126611,0,
2020-08-30,554,397,241,4,128,7,17,132603,127008,0,
2020-08-31,642,428,258,11,134,9,16,133245,127436,0,
2020-09-01,746,513,301,18,162,7,25,133991,127949,0,
2020-09-02,774,528,332,12,152,8,24,134765,128477,0,
2020-09-03,657,454,267,5,163,4,15,135422,128931,0,
2020-09-04,719,478,286,9,160,10,13,136141,129409,0,
2020-09-05,665,414,254,9,126,9,16,136806,129823,0,
2020-09-06,683,421,269,4,135,8,5,137489,130244,0,
2020-09-07,787,489,299,9,159,9,13,138276,130733,1,
2020-09-08,954,610,352,14,218,10,16,139230,131343,0,
2020-09-09,1008,627,375,12,217,4,19,140238,131970,0,
2020-09-10,998,649,372,6,232,9,30,141236,132619,0,
2020-09-11,973,641,356,10,251,9,15,142209,133260,0,
2020-09-12,975,654,388,8,238,3,17,143184,133914,0,
2020-09-13,969,611,344,8,241,6,12,144153,134525,0,
2020-09-14,1259,800,479,13,274,7,27,145412,135325,0,
2020-09-15,1312,803,447,10,307,3,36,146724,136128,0,
2020-09-16,1355,819,495,22,273,4,25,148079,136947,0,
2020-09-17,1322,771,479,21,239,6,26,149401,137718,0,
2020-09-18,1424,805,519,8,243,1,34,150825,138523,0,
2020-09-19,1236,708,393,18,273,6,18,152061,139231,0,
2020-09-20,1357,758,418,12,283,9,36,153418,139989,0,
2020-09-21,1812,1014,560,16,379,6,53,155230,141003,0,
2020-09-22,1857,959,519,13,371,7,49,157087,141962,0,
2020-09-23,1906,1008,556,15,345,2,90,158993,142970,0,
2020-09-24,1955,985,524,9,357,2,93,160948,143955,0,
2020-09-25,2050,1061,563,20,373,9,96,162998,145016,0,
2020-09-26,1880,951,505,7,338,4,97,164878,145967,0,
2020-09-27,1965,968,479,10,353,6,120,166843,146935,0,
2020-09-28,2469,1198,625,16,420,3,134,169312,148133,0,
2020-09-29,2263,1128,551,23,408,3,143,171575,149261,0,
2020-09-30,2253,1128,564,16,438,1,109,173828,150389,0,
2020-10-01,2167,1113,582,9,420,9,93,175995,151502,0,
2020-10-02,2128,1083,548,17,405,9,104,178123,152585,0,
2020-10-03,1821,940,474,19,348,10,89,179944,153525,0,
2020-10-04,1838,921,508,14,317,4,78,181782,154446,0,
2020-10-05,2442,1266,676,20,457,4,109,184224,155712,0,
2020-10-06,2319,1260,675,31,422,10,122,186543,156972,0,
2020-10-07,2276,1261,688,20,436,9,108,188819,158233,0,
2020-10-08,2235,1189,655,14,405,10,105,191054,159422,0,
2020-10-09,2299,1250,654,18,459,7,112,193353,160672,0,
2020-10-10,2167,1337,682,17,549,7,82,195520,162009,0,
2020-10-11,1910,1116,604,17,397,5,93,197430,163125,0,
2020-10-12,2335,1337,717,19,499,8,94,199765,164462,0,
2020-10-13,2571,1524,864,22,523,9,106,202336,165986,0,
2020-10-14,2511,1522,879,27,507,7,102,204847,167508,0,
2020-10-15,2566,1417,841,24,443,9,100,207413,168925,0,
2020-10-16,2657,1595,893,19,573,4,106,210070,170520,0,
2020-10-17,2303,1382,817,25,428,6,106,212373,171902,0,
2020-10-18,2230,1377,804,13,456,12,92,214603,173279,0,
2020-10-19,2957,1881,1122,22,609,7,121,217560,175160,0,
2020-10-20,2823,1853,1101,27,565,9,151,220383,177013,0,
2020-10-21,2789,1743,1010,33,542,9,149,223172,178756,0,
2020-10-22,2797,1794,1092,21,551,2,128,225969,180550,0,
2020-10-23,2824,1810,1047,31,592,7,133,228793,182360,0,
2020-10-24,2641,1757,1037,34,526,10,150,231434,184117,0,
2020-10-25,2641,1674,1023,31,498,7,115,234075,185791,0,
2020-10-26,3385,2159,1269,23,664,10,193,237460,187950,0,
2020-10-27,3347,2198,1350,36,641,9,162,240807,190148,0,
2020-10-28,3629,2430,1433,38,753,9,197,244436,192578,0,
2020-10-29,3097,1978,1252,33,564,7,122,247533,194556,0,
2020-10-30,3523,2322,1332,44,783,10,153,251056,196878,0,
2020-10-31,3148,2148,1354,32,616,8,138,254204,199026,0,
2020-11-01,3449,2287,1383,33,715,8,148,257653,201313,0,
2020-11-02,4566,3023,1849,43,928,7,196,262219,204336,0,
2020-11-03,4492,3022,1801,34,896,15,276,266711,207358,0,
2020-11-04,4616,3052,1917,48,881,7,199,271327,210410,0,
2020-11-05,4538,3022,1755,34,943,8,282,275865,213432,0,
2020-11-06,4614,3066,1811,22,978,10,245,280479,216498,0,
2020-11-07,4309,2844,1529,17,1079,9,210,284788,219342,0,
2020-11-08,4030,2653,1454,13,1004,8,174,288818,221995,0,
2020-11-09,5293,3525,1823,26,1415,14,247,294111,225520,0,
2020-11-10,5127,3409,1739,19,1403,14,234,299238,228929,0,
2020-11-11,4939,3384,1821,26,1315,9,213,304177,232313,0,
2020-11-12,5037,3536,1709,19,1567,12,229,309214,235849,0,
2020-11-13,5180,3693,1783,17,1654,16,223,314394,239542,0,
2020-11-14,4532,3385,1695,11,1490,13,176,318926,242927,0,
2020-11-15,4459,3291,1639,22,1464,18,148,323385,246218,0,
2020-11-16,5602,4058,2042,17,1809,21,169,328987,250276,0,
2020-11-17,5412,3961,1913,19,1791,13,225,334399,254237,0,
2020-11-18,5651,4174,2106,28,1839,12,189,340050,258411,0,
2020-11-19,5492,3944,1864,24,1830,16,210,345542,262355,0,
2020-11-20,5523,4116,1983,30,1877,15,211,351065,266471,0,
2020-11-21,5070,3773,1826,23,1741,15,168,356135,270244,0,
2020-11-22,4853,3524,1760,26,1540,22,176,360988,273768,0,
2020-11-23,6323,4573,2264,35,2016,16,242,367311,278341,0,
2020-11-24,6226,4596,2189,31,2104,10,262,373537,282937,0,
2020-11-25,6387,4666,2186,28,2122,15,315,379924,287603,0,
2020-11-26,6098,4532,2147,30,2139,17,199,386022,292135,0,
2020-11-27,6246,4523,2092,34,2162,18,217,392268,296658,0,
2020-11-28,5584,4054,1988,23,1749,15,279,397852,300712,0,
2020-11-29,5409,3840,1715,31,1845,15,234,403261,304552,0,
2020-11-30,6908,4918,2302,37,2286,21,272,410169,309470,0,
2020-12-01,6773,4798,2332,21,2180,7,258,416942,314268,0,
2020-12-02,6695,4788,2145,38,2334,13,258,423637,319056,0,
2020-12-03,6701,4685,2184,34,2160,17,290,430338,323741,0,
2020-12-04,6790,4776,2202,41,2251,10,272,437128,328517,0,
2020-12-05,5825,4075,1841,39,1933,12,250,442953,332592,0,
2020-12-06,5798,3976,1927,34,1727,31,257,448751,336568,0,
2020-12-07,7643,5288,2516,48,2350,26,348,456394,341856,0,
2020-12-08,7167,4879,2277,40,2186,16,360,463561,346735,0,
2020-12-09,6904,4738,2225,31,2091,19,372,470465,351473,0,
2020-12-10,6851,4638,2113,46,2109,24,346,477316,356111,0,
2020-12-11,6828,4685,2129,50,2132,22,352,484144,360796,0,
2020-12-12,6163,4065,1870,43,1812,24,316,490307,364861,0,
2020-12-13,5523,3645,1746,27,1579,16,277,495830,368506,0,
2020-12-14,7674,5069,2322,42,2211,29,465,503504,373575,0,
2020-12-15,7202,4756,2138,33,2139,17,429,510706,378331,0,
2020-12-16,6866,4547,2104,47,1962,9,425,517572,382878,0,
2020-12-17,6633,4314,1898,36,1946,26,408,524205,387192,0,
2020-12-18,6903,4519,2020,53,1994,20,432,531108,391711,0,
2020-12-19,5899,3720,1775,41,1588,17,299,537007,395431,0,
2020-12-20,5882,3749,1824,32,1568,20,305,542889,399180,0,
2020-12-21,7562,4693,2221,41,1943,16,472,550451,403873,0,
2020-12-22,7106,4372,2157,44,1733,22,416,557557,408245,0,
2020-12-23,7383,4606,2272,49,1811,30,444,564940,412851,0,
2020-12-24,6884,4403,2132,44,1813,14,400,571824,417254,0,
2020-12-25,5696,3492,1820,52,1332,15,273,577520,420746,0,
2020-12-26,7589,4979,2569,59,1983,24,344,585109,425725,0,
2020-12-27,7540,4933,2674,69,1798,20,372,592649,430658,0,
2020-12-28,8929,5741,3010,52,2203,25,451,601578,436399,0,
2020-12-29,8129,5279,2819,72,1925,16,447,609707,441678,0,
2020-12-30,7821,4993,2656,59,1774,39,465,617528,446671,0,
2020-12-31,7418,4919,2615,57,1805,15,427,624946,451590,0,
2021-01-01,6790,4462,2382,40,1650,28,362,631736,456052,0,
2021-01-02,7500,5075,2754,69,1777,43,432,639236,461127,0,
2021-01-03,7289,4720,2553,61,1675,48,383,646525,465847,0,
2021-01-04,8905,5810,3093,69,2061,32,555,655430,471657,0,
2021-01-05,7764,5124,2804,64,1730,48,478,663194,476781,0,
2021-01-06,7710,4987,2657,60,1665,53,552,670904,481768,0,
2021-01-07,6869,4427,2365,54,1480,37,491,677773,486195,0,
2021-01-08,6743,4418,2347,58,1486,39,488,684516,490613,0,
2021-01-09,5969,3873,2067,54,1311,40,401,690485,494486,0,
2021-01-10,5566,3665,1945,58,1256,29,377,696051,498151,0,
2021-01-11,6866,4572,2480,59,1499,36,498,702917,502723,0,
2021-01-12,6076,4009,2161,71,1298,30,449,708993,506732,0,
2021-01-13,6072,4024,2118,49,1349,32,476,715065,510756,0,
2021-01-14,5633,3812,2072,44,1227,28,441,720698,514568,0,
2021-01-15,5992,3878,2060,40,1350,30,398,726690,518446,0,
2021-01-16,4693,3157,1684,37,1128,20,288,731383,521603,0,
2021-01-17,4459,2975,1580,38,996,36,325,735842,524578,0,
2021-01-18,5638,3772,1992,40,1235,29,476,741480,528350,0,
2021-01-19,5196,3454,1825,48,1116,12,453,746676,531804,0,
2021-01-20,5038,3367,1830,56,1090,24,367,751714,535171,0,
2021-01-21,4760,3172,1683,30,1041,26,392,756474,538343,0,
2021-01-22,4501,3050,1656,39,1028,18,309,760975,541393,0,
2021-01-23,3929,2652,1431,43,882,15,281,764904,544045,0,
2021-01-24,3488,2336,1244,28,808,11,245,768392,546381,0,
2021-01-25,4615,3004,1606,37,951,18,392,773007,549385,0,
2021-01-26,4073,2650,1413,40,847,8,342,777080,552035,0,
2021-01-27,4146,2769,1509,28,902,15,315,781226,554804,0,
2021-01-28,3849,2491,1329,31,852,16,263,785075,557295,0,
2021-01-29,3743,2436,1291,40,861,14,230,788818,559731,0,
2021-01-30,3138,2072,1070,23,742,10,227,791956,561803,0,
2021-01-31,2850,1875,1045,24,615,18,173,794806,563678,0,
2021-02-01,4088,2681,1351,21,915,15,379,798894,566359,0,
2021-02-02,3605,2357,1267,33,795,10,252,802499,568716,0,
2021-02-03,3532,2292,1222,22,803,10,235,806031,571008,0,
2021-02-04,3347,2182,1156,26,742,13,245,809378,573190,0,
2021-02-05,3366,2205,1143,26,777,16,243,812744,575395,0,
2021-02-06,2784,1861,1032,18,673,7,131,815528,577256,0,
2021-02-07,2629,1735,957,24,606,11,137,818157,578991,0,
2021-02-08,3492,2269,1263,19,758,9,220,821649,581260,0,
2021-02-09,3223,2024,1104,29,701,13,177,824872,583284,0,
2021-02-10,3286,2171,1251,29,753,5,133,828158,585455,0,
2021-02-11,2880,1925,1150,24,610,7,134,831038,587380,0,
2021-02-12,3101,2055,1164,21,692,7,171,834139,589435,0,
2021-02-13,2670,1873,1100,17,597,4,155,836809,591308,0,
2021-02-14,2527,1698,1003,16,567,20,92,839336,593006,0,
2021-02-15,3036,2003,1175,33,666,6,123,842372,595009,0,
2021-02-16,3003,2088,1240,27,645,13,163,845375,597097,0,
2021-02-17,3081,2130,1271,29,650,8,172,848456,599227,0,
2021-02-18,3009,2106,1258,31,613,7,197,851465,601333,0,
2021-02-19,2995,2085,1217,24,675,5,164,854460,603418,0,
2021-02-20,2737,1879,1117,26,604,10,122,857197,605297,0,
2021-02-21,2526,1790,1022,14,622,10,122,859723,607087,0,
2021-02-22,3196,2212,1296,15,702,6,193,862919,609299,0,
2021-02-23,3003,2131,1281,11,684,4,151,865922,611430,0,
2021-02-24,3108,2157,1307,18,659,7,166,869030,613587,0,
2021-02-25,2833,2009,1215,16,628,4,146,871863,615596,0,
2021-02-26,2929,2092,1274,19,630,10,159,874792,617688,0,
2021-02-27,2698,1992,1200,11,615,13,153,877490,619680,0,
2021-02-28,2647,1955,1179,21,605,9,141,880137,621635,0,
2021-03-01,3505,2535,1468,19,828,6,214,883642,624170,0,
2021-03-02,3112,2280,1387,22,692,7,172,886754,626450,0,
2021-03-03,3283,2370,1457,19,727,14,153,890037,628820,0,
2021-03-04,2859,2149,1284,22,683,15,145,892896,630969,0,
2021-03-05,3221,2397,1496,21,709,3,168,896117,633366,0,
2021-03-06,2818,2113,1282,5,661,10,155,898935,635479,0,
2021-03-07,2707,2030,1195,13,684,9,129,901642,637509,0,
2021-03-08,3546,2677,1605,13,837,19,203,905188,640186,0,
2021-03-09,3355,2573,1557,24,778,10,204,908543,642759,0,
2021-03-10,3677,2803,1710,23,825,16,229,912220,645562,0,
2021-03-11,3287,2481,1498,15,752,17,199,915507,648043,0,
2021-03-12,3396,2610,1560,10,795,15,230,918903,650653,0,
2021-03-13,3160,2432,1515,10,738,10,159,922063,653085,0,
2021-03-14,3065,2297,1372,11,737,25,152,925128,655382,0,
2021-03-15,4156,3310,1990,12,1064,17,227,929284,658692,0,
2021-03-16,4005,3119,1917,11,955,13,223,933289,661811,0,
2021-03-17,4395,3530,2224,9,1061,21,215,937684,665341,0,
2021-03-18,4004,3185,2033,12,925,16,199,941688,668526,0,
2021-03-19,4339,3426,2072,12,1088,19,235,946027,671952,0,
2021-03-20,4174,3309,1988,12,1101,8,200,950201,675261,0,
2021-03-21,4198,3325,1950,17,1108,31,219,954399,678586,0,
2021-03-22,5321,4148,2433,20,1399,13,283,959720,682734,0,
2021-03-23,5555,4335,2467,24,1512,24,308,965275,687069,0,
2021-03-24,5603,4482,2679,21,1441,29,312,970878,691551,0,
2021-03-25,5231,4084,2382,17,1365,16,304,976109,695635,0,
2021-03-26,5674,4484,2611,22,1473,25,353,981783,700119,0,
2021-03-27,5368,4226,2461,22,1460,13,270,987151,704345,0,
2021-03-28,5415,4243,2467,17,1446,30,283,992566,708588,0,
2021-03-29,6668,5296,3081,14,1823,22,356,999234,713884,0,
2021-03-30,6727,5284,3092,21,1789,29,353,1005961,719168,0,
2021-03-31,6801,5408,3154,30,1857,19,348,1012762,724576,0,
2021-04-01,7840,6341,3516,37,2209,18,561,1020602,730917,0,
2021-04-02,7151,5696,3289,35,1911,18,443,1027753,736613,0,
2021-04-03,7147,5656,3287,32,1798,16,523,1034900,742269,0,
2021-04-04,7399,5884,3371,29,1990,22,472,1042299,748153,0,
2021-04-05,9585,7706,4337,39,2631,34,665,1051884,755859,0,
2021-04-06,9593,7742,4424,49,2540,24,705,1061477,763601,0,
2021-04-07,9619,7786,4436,43,2565,27,715,1071096,771387,0,
2021-04-08,8980,7270,4081,38,2381,22,748,1080076,778657,0,
2021-04-09,9021,7262,3969,41,2457,41,754,1089097,785919,0,
2021-04-10,8560,7021,3852,41,2386,32,710,1097657,792940,0,
2021-04-11,7809,6345,3463,32,2199,29,622,1105466,799285,0,
2021-04-12,9280,7512,4233,40,2415,35,789,1114746,806797,0,
2021-04-13,8651,7081,3975,32,2302,28,744,1123397,813878,0,
2021-04-14,8784,7225,4018,38,2289,34,846,1132181,821103,0,
2021-04-15,8082,6703,3776,29,2097,20,781,1140263,827806,0,
2021-04-16,8279,6920,3846,23,2342,28,681,1148542,834726,0,
2021-04-17,7876,6583,3724,36,2103,25,695,1156418,841309,0,
2021-04-18,7194,6060,3383,26,1989,35,627,1163612,847369,0,
2021-04-19,8756,7360,4119,36,2377,44,784,1172368,854729,0,
2021-04-20,8268,6982,4055,27,2205,31,664,1180636,861711,0,
2021-04-21,8195,6988,4030,28,2225,56,649,1188831,868699,0,
2021-04-22,7625,6482,3718,18,2106,55,585,1196456,875181,0,
2021-04-23,8066,6931,3950,33,2197,49,702,1204522,882112,0,
2021-04-24,7289,6152,3571,22,1975,22,562,1211811,888264,0,
2021-04-25,6754,5693,3341,21,1837,30,464,1218565,893957,0,
2021-04-26,8195,6950,4023,27,2209,43,648,1226760,900907,0,
2021-04-27,7631,6488,3839,21,1982,19,627,1234391,907395,0,
2021-04-28,8131,6896,4004,27,2148,20,697,1242522,914291,0,
2021-04-29,7119,6032,3561,24,1807,11,629,1249641,920323,0,
2021-04-30,7382,6293,3628,24,1934,35,672,1257023,926616,0,
2021-05-01,7020,6063,3540,18,1986,12,507,1264043,932679,0,
2021-05-02,6113,5254,3176,27,1603,12,436,1270156,937933,0,
2021-05-03,7512,6388,3819,26,2045,19,479,1277668,944321,0,
2021-05-04,6874,5795,3579,22,1777,25,392,1284542,950116,0,
2021-05-05,6749,5758,3518,27,1808,19,386,1291291,955874,0,
2021-05-06,6158,5166,3162,11,1605,14,374,1297449,961040,0,
2021-05-07,6284,5271,3219,19,1673,21,339,1303733,966311,0,
2021-05-08,5606,4734,2899,25,1512,10,288,1309339,971045,0,
2021-05-09,5004,4231,2648,20,1346,5,212,1314343,975276,0,
2021-05-10,6297,5234,3145,26,1687,18,358,1320640,980510,0,
2021-05-11,5481,4550,2753,25,1443,6,323,1326121,985060,0,
2021-05-12,5453,4545,2795,19,1467,6,258,1331574,989605,0,
2021-05-13,4948,4101,2544,19,1290,12,236,1336522,993706,0,
2021-05-14,4900,4050,2414,11,1341,10,274,1341422,997756,0,
2021-05-15,4287,3546,2148,9,1152,9,228,1345709,1001302,0,
2021-05-16,3797,3124,1856,6,1079,11,172,1349506,1004426,0,
2021-05-17,4525,3696,2200,9,1172,13,302,1354031,1008122,0,
2021-05-18,4079,3285,1935,11,1066,6,267,1358110,1011407,0,
2021-05-19,3696,2991,1820,13,966,2,190,1361806,1014398,0,
2021-05-20,3484,2824,1689,8,883,6,238,1365290,1017222,0,
2021-05-21,3266,2638,1578,7,832,7,214,1368556,1019860,0,
2021-05-22,2644,2170,1309,8,713,4,136,1371200,1022030,0,
2021-05-23,2299,1846,1094,1,635,3,113,1373499,1023876,0,
2021-05-24,2413,1945,1162,6,660,2,115,1375912,1025821,0,
2021-05-25,2688,2150,1345,1,665,5,134,1378600,1027971,0,
2021-05-26,2408,1928,1215,7,599,4,103,1381008,1029899,0,
2021-05-27,2228,1799,1159,6,539,5,90,1383236,1031698,0,
2021-05-28,2092,1685,1079,8,507,3,88,1385328,1033383,0,
2021-05-29,1679,1347,831,1,435,7,73,1387007,1034730,0,
2021-05-30,1532,1242,791,6,388,7,50,1388539,1035972,0,
2021-05-31,1978,1579,1036,1,464,6,72,1390517,1037551,0,
2021-06-01,1847,1503,934,8,469,8,84,1392364,1039054,0,
2021-06-02,1728,1374,897,3,415,2,57,1394092,1040428,0,
2021-06-03,1497,1218,794,5,356,4,59,1395589,1041646,0,
2021-06-04,1481,1169,744,3,355,5,62,1397070,1042815,0,
2021-06-05,1225,997,647,3,299,5,43,1398295,1043812,0,
2021-06-06,1097,872,571,0,264,2,35,1399392,1044684,0,
2021-06-07,1435,1141,756,3,326,5,51,1400827,1045825,0,
2021-06-08,1203,953,595,2,295,8,53,1402030,1046778,0,
2021-06-09,1201,957,641,6,236,7,67,1403231,1047735,0,
2021-06-10,1181,923,635,6,222,8,52,1404412,1048658,0,
2021-06-11,1056,817,521,1,232,10,53,1405468,1049475,0,
2021-06-12,905,712,457,4,185,9,57,1406373,1050187,0,
2021-06-13,767,608,377,2,183,2,44,1407140,1050795,0,
2021-06-14,1034,787,514,3,220,13,37,1408174,1051582,0,
2021-06-15,904,694,467,0,193,6,28,1409078,1052276,0,
2021-06-16,841,641,425,1,164,11,40,1409919,1052917,0,
2021-06-17,710,535,361,2,140,6,26,1410629,1053452,0,
2021-06-18,724,566,367,3,149,16,31,1411353,1054018,0,
2021-06-19,566,448,260,0,145,6,37,1411919,1054466,0,
2021-06-20,565,424,255,3,134,5,27,1412484,1054890,0,
2021-06-21,695,551,329,1,168,9,44,1413179,1055441,0,
2021-06-22,661,503,306,2,146,6,43,1413840,1055944,0,
2021-06-23,667,491,315,1,140,4,31,1414507,1056435,0,
2021-06-24,586,453,273,4,131,11,34,1415093,1056888,0,
2021-06-25,533,415,258,3,113,6,35,1415626,1057303,0,
2021-06-26,467,350,209,3,110,7,21,1416093,1057653,0,
2021-06-27,432,320,183,1,101,4,31,1416525,1057973,0,
2021-06-28,550,410,242,1,119,9,39,1417075,1058383,0,
2021-06-29,480,349,171,2,119,12,45,1417555,1058732,0,
2021-06-30,478,383,213,4,111,11,44,1418033,1059115,0,
2021-07-01,409,292,164,3,94,11,20,1418442,1059407,0,
2021-07-02,434,319,171,0,104,4,40,1418876,1059726,0,
2021-07-03,429,333,183,2,115,12,21,1419305,1060059,0,
2021-07-04,399,300,158,2,116,2,22,1419704,1060359,0,
2021-07-05,517,364,204,3,126,5,26,1420221,1060723,0,
2021-07-06,484,358,205,4,123,8,18,1420705,1061081,0,
2021-07-07,417,309,170,4,109,9,17,1421122,1061390,0,
2021-07-08,351,253,137,3,90,9,14,1421473,1061643,0,
2021-07-09,380,271,132,2,102,11,24,1421853,1061914,,
2021-07-10,349,264,135,2,106,12,9,1422202,1062178,,
2021-07-11,337,244,125,0,93,11,15,1422539,1062422,,
2021-07-12,471,360,187,1,141,12,19,1423010,1062782,,
2021-07-13,434,311,155,0,126,5,25,1423444,1063093,,
2021-07-14,480,334,169,0,126,17,22,1423924,1063427,,
2021-07-15,419,299,152,1,116,15,15,1424343,1063726,,
2021-07-16,466,346,178,6,126,16,20,1424809,1064072,,
2021-07-17,397,299,151,7,120,11,10,1425206,1064371,,
2021-07-18,484,353,166,7,148,16,16,1425690,1064724,,
2021-07-19,616,465,223,4,210,15,13,1426306,1065189,,
2021-07-20,686,515,251,10,229,11,14,1426992,1065704,,
2021-07-21,675,510,231,5,245,18,11,1427667,1066214,,
2021-07-22,621,452,221,9,196,13,13,1428288,1066666,,
2021-07-23,666,513,258,4,201,16,34,1428954,1067179,,
2021-07-24,634,491,279,4,183,14,11,1429588,1067670,,
2021-07-25,736,570,287,11,240,18,14,1430324,1068240,,
2021-07-26,1012,778,398,7,329,21,23,1431336,1069018,,
2021-07-27,966,734,380,10,309,12,23,1432302,1069752,,
2021-07-28,947,701,355,10,289,23,24,1433249,1070453,,
2021-07-29,938,685,341,12,295,18,19,1434187,1071138,,
2021-07-30,938,676,349,12,272,16,27,1435125,1071814,,
2021-07-31,950,741,357,9,325,23,27,1436075,1072555,,
2021-08-01,1125,866,449,17,355,21,24,1437200,1073421,,
2021-08-02,1441,1045,464,20,508,27,26,1438641,1074466,,
2021-08-03,1705,1264,583,17,580,27,57,1440346,1075730,,
2021-08-04,1641,1188,540,21,565,16,46,1441987,1076918,,
2021-08-05,1688,1154,570,14,516,22,32,1443675,1078072,,
2021-08-06,1589,1071,509,15,482,18,47,1445264,1079143,,
2021-08-07,1612,1200,570,11,553,22,44,1446876,1080343,,
2021-08-08,1736,1230,593,23,558,17,39,1448612,1081573,,
2021-08-09,2253,1550,760,22,703,18,47,1450865,1083123,,
2021-08-10,2377,1682,776,27,782,37,60,1453242,1084805,,
2021-08-11,2298,1627,763,29,759,21,55,1455540,1086432,,
2021-08-12,1996,1429,689,26,634,31,49,1457536,1087861,,
2021-08-13,1992,1438,692,15,641,30,60,1459528,1089299,,
2021-08-14,1982,1485,740,18,649,26,52,1461510,1090784,,
2021-08-15,1898,1408,700,17,629,17,45,1463408,1092192,,
2021-08-16,2529,1844,867,29,844,28,76,1465937,1094036,,
2021-08-17,2369,1724,829,21,783,24,67,1468306,1095760,,
2021-08-18,2195,1540,727,30,687,19,77,1470501,1097300,,
2021-08-19,1906,1287,668,10,508,13,88,1472407,1098587,,
2021-08-20,1553,987,520,6,360,9,92,1473960,1099574,,
2021-08-21,973,628,326,3,217,3,79,1474933,1100202,,
2021-08-22,818,425,203,0,117,1,104,1475751,1100627,,
2021-08-23,1015,360,116,0,67,6,171,1476766,1100987,,
2021-08-24,999,286,34,0,15,3,234,1477765,1101273,,
2021-08-25,260,37,3,0,2,1,31,1478025,1101310,,
2021-08-26,3,0,0,0,0,0,0,1478028,1101310,,