date,new,NTotal_ExposureOnly,domestic-contactWithCase,domestic-contactWithTraveller,domestic-unknown,internationalTravel,infopending,cumulative,cumulativeNTotal_ExposureOnly,doubleFlagTest,shaded
2020-01-15,2,1,0,0,0,1,0,2,1,1,14
2020-01-16,4,4,1,0,3,0,0,6,5,1,
2020-01-17,1,1,0,0,0,1,0,7,6,0,
2020-01-18,0,0,0,0,0,0,0,7,6,0,
2020-01-19,0,0,0,0,0,0,0,7,6,0,
2020-01-20,0,0,0,0,0,0,0,7,6,0,
2020-01-21,2,1,0,0,1,0,0,9,7,0,
2020-01-22,4,4,0,0,2,2,0,13,11,1,
2020-01-23,0,0,0,0,0,0,0,13,11,0,
2020-01-24,3,3,0,0,1,2,0,16,14,0,
2020-01-25,2,2,1,0,1,0,0,18,16,0,
2020-01-26,3,3,2,0,1,0,0,21,19,0,
2020-01-27,8,7,4,0,3,0,0,29,26,1,
2020-01-28,6,6,0,0,4,1,1,35,32,0,
2020-01-29,2,2,1,0,1,0,0,37,34,0,
2020-01-30,2,1,0,0,0,0,1,39,35,0,
2020-01-31,4,2,1,0,1,0,0,43,37,0,
2020-02-01,5,5,3,0,1,1,0,48,42,0,
2020-02-02,4,4,0,0,3,1,0,52,46,0,
2020-02-03,1,1,0,0,1,0,0,53,47,0,
2020-02-04,2,2,0,0,2,0,0,55,49,0,
2020-02-05,2,2,0,0,1,1,0,57,51,0,
2020-02-06,0,0,0,0,0,0,0,57,51,0,
2020-02-07,1,1,1,0,0,0,0,58,52,1,
2020-02-08,1,0,0,0,0,0,0,59,52,0,
2020-02-09,2,2,1,0,0,1,0,61,54,0,
2020-02-10,2,2,0,0,1,1,0,63,56,0,
2020-02-11,1,1,0,0,1,0,0,64,57,0,
2020-02-12,5,3,2,0,1,0,0,69,60,0,
2020-02-13,1,1,0,0,0,1,0,70,61,0,
2020-02-14,6,5,0,0,3,2,0,76,66,0,
2020-02-15,2,2,1,0,0,1,0,78,68,0,
2020-02-16,1,1,0,0,0,1,0,79,69,0,
2020-02-17,2,2,1,0,0,1,0,81,71,0,
2020-02-18,2,2,2,0,0,0,0,83,73,0,
2020-02-19,3,3,1,0,1,1,0,86,76,0,
2020-02-20,9,9,4,1,2,2,0,95,85,0,
2020-02-21,2,2,0,0,0,2,0,97,87,0,
2020-02-22,8,8,2,0,3,3,0,105,95,0,
2020-02-23,20,20,9,0,4,7,0,125,115,1,
2020-02-24,15,15,3,0,2,9,1,140,130,0,
2020-02-25,16,16,4,0,2,10,0,156,146,0,
2020-02-26,13,13,6,1,4,2,0,169,159,0,
2020-02-27,25,25,13,0,5,7,0,194,184,0,
2020-02-28,37,37,19,0,4,14,0,231,221,0,
2020-02-29,27,27,10,0,5,12,0,258,248,1,
2020-03-01,59,59,17,0,19,20,3,317,307,0,
2020-03-02,54,54,9,0,15,30,0,371,361,0,
2020-03-03,56,56,18,0,9,29,0,427,417,0,
2020-03-04,59,58,18,1,10,29,0,486,475,0,
2020-03-05,64,64,12,1,20,31,0,550,539,1,
2020-03-06,86,86,18,2,25,40,1,636,625,0,
2020-03-07,91,91,18,3,25,45,0,727,716,0,
2020-03-08,135,135,34,2,39,60,0,862,851,0,
2020-03-09,221,221,67,9,55,90,0,1083,1072,0,
2020-03-10,264,264,67,9,62,125,1,1347,1336,1,
2020-03-11,306,306,89,11,78,127,1,1653,1642,0,
2020-03-12,393,393,106,8,117,162,0,2046,2035,0,
2020-03-13,462,461,131,8,144,177,1,2508,2496,0,
2020-03-14,479,479,111,14,160,193,1,2987,2975,1,
2020-03-15,603,602,175,10,190,225,2,3590,3577,0,
2020-03-16,839,837,268,11,287,269,2,4429,4414,0,
2020-03-17,894,891,280,16,310,281,4,5323,5305,0,
2020-03-18,967,963,304,19,342,293,5,6290,6268,1,
2020-03-19,807,798,267,12,280,235,4,7097,7066,0,
2020-03-20,1065,1063,397,21,399,236,10,8162,8129,0,
2020-03-21,893,887,327,11,311,234,4,9055,9016,0,
2020-03-22,874,867,337,13,327,188,2,9929,9883,0,
2020-03-23,1098,1088,485,16,407,171,9,11027,10971,0,
2020-03-24,995,987,414,21,374,176,2,12022,11958,0,
2020-03-25,1008,1000,476,13,393,114,4,13030,12958,1,
2020-03-26,939,930,467,12,338,111,2,13969,13888,0,
2020-03-27,961,946,496,9,351,81,9,14930,14834,0,
2020-03-28,972,964,509,9,358,81,7,15902,15798,0,
2020-03-29,891,883,489,7,333,53,1,16793,16681,0,
2020-03-30,1185,1180,634,10,452,77,7,17978,17861,0,
2020-03-31,1008,1003,583,3,343,70,4,18986,18864,0,
2020-04-01,1323,1311,816,12,399,79,5,20309,20175,0,
2020-04-02,1199,1192,798,11,335,45,3,21508,21367,0,
2020-04-03,1343,1338,935,5,344,52,2,22851,22705,0,
2020-04-04,1185,1183,834,9,305,30,5,24036,23888,0,
2020-04-05,1083,1082,744,5,316,14,3,25119,24970,0,
2020-04-06,1437,1435,926,11,482,13,3,26556,26405,1,
2020-04-07,1326,1324,868,14,421,17,4,27882,27729,0,
2020-04-08,1412,1407,956,10,431,6,4,29294,29136,0,
2020-04-09,1501,1500,1011,14,471,4,0,30795,30636,0,
2020-04-10,1819,1818,1255,19,534,6,4,32614,32454,0,
2020-04-11,1699,1698,1150,11,528,4,5,34313,34152,0,
2020-04-12,1451,1450,982,16,440,7,5,35764,35602,0,
2020-04-13,2127,2127,1306,33,775,6,7,37891,37729,0,
2020-04-14,1810,1810,1197,21,589,2,1,39701,39539,0,
2020-04-15,1948,1945,1336,22,578,4,5,41649,41484,0,
2020-04-16,1946,1944,1257,18,666,1,2,43595,43428,0,
2020-04-17,1853,1850,1200,17,629,3,1,45448,45278,0,
2020-04-18,1605,1604,1104,20,476,3,1,47053,46882,0,
2020-04-19,1229,1227,794,15,409,4,5,48282,48109,0,
2020-04-20,1855,1851,1202,11,630,3,5,50137,49960,0,
2020-04-21,1402,1402,891,13,487,7,4,51539,51362,0,
2020-04-22,1559,1558,956,14,583,1,4,53098,52920,0,
2020-04-23,1570,1567,982,19,560,2,4,54668,54487,1,
2020-04-24,1535,1534,988,11,528,2,5,56203,56021,0,
2020-04-25,1398,1395,901,14,470,6,4,57601,57416,0,
2020-04-26,1316,1316,853,13,443,4,3,58917,58732,0,
2020-04-27,1636,1634,984,12,626,5,7,60553,60366,0,
2020-04-28,1530,1523,945,18,549,6,5,62083,61889,0,
2020-04-29,1487,1486,842,4,634,2,4,63570,63375,0,
2020-04-30,1452,1449,860,4,576,3,6,65022,64824,0,
2020-05-01,1589,1589,931,8,643,4,3,66611,66413,0,
2020-05-02,1067,1066,678,8,377,0,3,67678,67479,0,
2020-05-03,1014,1013,622,6,379,5,1,68692,68492,0,
2020-05-04,1354,1354,807,6,535,1,5,70046,69846,0,
2020-05-05,1289,1287,785,6,491,2,3,71335,71133,0,
2020-05-06,1117,1116,669,8,432,2,5,72452,72249,0,
2020-05-07,1173,1170,739,4,421,6,0,73625,73419,0,
2020-05-08,1178,1177,723,7,438,2,7,74803,74596,0,
2020-05-09,1019,1016,650,8,353,4,1,75822,75612,0,
2020-05-10,920,919,562,7,342,4,4,76742,76531,0,
2020-05-11,1220,1219,748,8,453,6,4,77962,77750,0,
2020-05-12,1154,1153,745,2,397,6,3,79116,78903,0,
2020-05-13,1103,1102,678,3,418,3,0,80219,80005,0,
2020-05-14,1146,1146,697,3,437,5,4,81365,81151,0,
2020-05-15,1214,1214,723,0,479,11,1,82579,82365,0,
2020-05-16,995,994,614,2,376,1,1,83574,83359,0,
2020-05-17,913,913,559,2,343,8,1,84487,84272,0,
2020-05-18,1096,1094,641,2,443,5,3,85583,85366,0,
2020-05-19,944,944,589,3,347,4,1,86527,86310,0,
2020-05-20,1111,1110,676,2,424,2,6,87638,87420,0,
2020-05-21,894,894,569,2,315,6,2,88532,88314,0,
2020-05-22,840,838,517,0,316,5,0,89372,89152,0,
2020-05-23,700,700,460,1,233,6,0,90072,89852,0,
2020-05-24,640,640,410,0,226,2,2,90712,90492,0,
2020-05-25,846,846,507,3,326,5,5,91558,91338,0,
2020-05-26,735,735,455,1,271,8,0,92293,92073,0,
2020-05-27,710,710,438,2,268,1,1,93003,92783,0,
2020-05-28,592,592,366,2,221,2,1,93595,93375,0,
2020-05-29,718,718,456,0,259,3,0,94313,94093,0,
2020-05-30,563,562,393,2,165,1,1,94876,94655,0,
2020-05-31,405,405,261,0,140,4,0,95281,95060,0,
2020-06-01,689,687,414,6,260,6,1,95970,95747,0,
2020-06-02,490,490,322,1,159,6,2,96460,96237,0,
2020-06-03,496,496,327,4,162,3,0,96956,96733,0,
2020-06-04,463,462,267,1,182,11,1,97419,97195,0,
2020-06-05,460,458,316,0,138,4,0,97879,97653,0,
2020-06-06,362,361,248,1,106,6,0,98241,98014,0,
2020-06-07,312,310,215,1,93,1,0,98553,98324,0,
2020-06-08,421,419,279,6,120,12,2,98974,98743,0,
2020-06-09,371,371,246,3,115,7,0,99345,99114,0,
2020-06-10,430,428,271,5,141,10,1,99775,99542,0,
2020-06-11,375,374,244,3,119,8,0,100150,99916,0,
2020-06-12,365,363,231,5,121,6,0,100515,100279,0,
2020-06-13,276,276,177,1,89,7,2,100791,100555,0,
2020-06-14,301,300,193,0,98,9,0,101092,100855,0,
2020-06-15,401,401,248,4,140,8,1,101493,101256,0,
2020-06-16,362,361,231,2,115,12,1,101855,101617,0,
2020-06-17,361,360,224,0,130,5,1,102216,101977,0,
2020-06-18,328,327,202,1,117,6,1,102544,102304,0,
2020-06-19,343,343,238,0,92,12,1,102887,102647,0,
2020-06-20,281,281,187,0,84,9,1,103168,102928,0,
2020-06-21,272,271,173,0,93,4,1,103440,103199,0,
2020-06-22,326,325,209,2,105,7,2,103766,103524,0,
2020-06-23,320,320,217,2,96,5,0,104086,103844,0,
2020-06-24,283,283,182,2,89,10,0,104369,104127,0,
2020-06-25,460,460,324,2,128,6,0,104829,104587,0,
2020-06-26,272,271,166,0,94,10,1,105101,104858,0,
2020-06-27,253,252,165,1,79,7,0,105354,105110,0,
2020-06-28,242,239,141,1,86,10,1,105596,105349,0,
2020-06-29,328,326,200,2,112,11,1,105924,105675,0,
2020-06-30,306,304,196,4,101,3,0,106230,105979,0,
2020-07-01,286,279,175,8,90,6,0,106516,106258,0,
2020-07-02,266,263,163,1,92,7,0,106782,106521,0,
2020-07-03,303,299,176,2,107,14,0,107085,106820,0,
2020-07-04,298,294,163,3,116,12,0,107383,107114,0,
2020-07-05,277,277,157,3,111,6,0,107660,107391,0,
2020-07-06,498,493,274,2,197,20,0,108158,107884,0,
2020-07-07,518,516,244,6,244,21,1,108676,108400,0,
2020-07-08,443,435,270,4,149,11,1,109119,108835,0,
2020-07-09,444,436,264,3,154,14,1,109563,109271,1,
2020-07-10,410,402,252,5,129,15,1,109973,109673,0,
2020-07-11,385,385,222,3,145,14,1,110358,110058,0,
2020-07-12,405,402,240,3,151,8,0,110763,110460,0,
2020-07-13,602,588,331,12,226,18,1,111365,111048,0,
2020-07-14,552,541,311,4,212,14,0,111917,111589,0,
2020-07-15,561,555,303,3,229,19,1,112478,112144,0,
2020-07-16,455,444,250,3,176,14,1,112933,112588,0,
2020-07-17,497,494,270,6,210,6,2,113430,113082,0,
2020-07-18,403,397,235,2,152,8,0,113833,113479,0,
2020-07-19,397,391,205,4,171,11,0,114230,113870,0,
2020-07-20,553,537,281,6,236,14,0,114783,114407,0,
2020-07-21,499,494,240,10,237,6,1,115282,114901,0,
2020-07-22,440,437,184,6,234,13,0,115722,115338,0,
2020-07-23,430,424,170,3,245,6,0,116152,115762,0,
2020-07-24,449,441,176,7,254,4,0,116601,116203,0,
2020-07-25,315,313,114,4,183,11,1,116916,116516,0,
2020-07-26,330,325,108,6,198,10,3,117246,116841,0,
2020-07-27,467,457,177,3,260,17,0,117713,117298,0,
2020-07-28,408,402,142,1,248,11,0,118121,117700,0,
2020-07-29,396,391,133,1,254,2,1,118517,118091,0,
2020-07-30,336,329,119,1,198,6,5,118853,118420,0,
2020-07-31,337,333,115,0,206,12,0,119190,118753,0,
2020-08-01,329,324,108,8,188,18,2,119519,119077,0,
2020-08-02,334,330,127,6,189,8,0,119853,119407,0,
2020-08-03,426,425,152,2,261,9,1,120279,119832,0,
2020-08-04,427,420,168,0,231,18,3,120706,120252,0,
2020-08-05,374,373,159,9,198,7,0,121080,120625,0,
2020-08-06,350,343,155,4,176,7,1,121430,120968,0,
2020-08-07,390,390,194,2,187,5,2,121820,121358,0,
2020-08-08,325,323,136,4,181,2,0,122145,121681,0,
2020-08-09,308,304,131,7,160,6,0,122453,121985,0,
2020-08-10,467,466,198,8,249,11,0,122920,122451,0,
2020-08-11,481,474,229,5,230,10,0,123401,122925,0,
2020-08-12,375,371,175,11,171,13,1,123776,123296,0,
2020-08-13,442,435,233,8,183,11,0,124218,123731,0,
2020-08-14,359,358,153,7,188,9,1,124577,124089,0,
2020-08-15,381,378,169,7,195,7,0,124958,124467,0,
2020-08-16,390,387,169,14,198,6,0,125348,124854,0,
2020-08-17,521,521,228,12,272,9,0,125869,125375,0,
2020-08-18,410,406,179,4,215,6,2,126279,125781,0,
2020-08-19,449,446,205,9,225,6,1,126728,126227,0,
2020-08-20,447,447,211,5,225,5,1,127175,126674,0,
2020-08-21,415,414,201,9,197,6,1,127590,127088,0,
2020-08-22,401,401,206,7,182,6,0,127991,127489,0,
2020-08-23,401,401,181,3,210,7,0,128392,127890,0,
2020-08-24,549,549,230,15,295,8,1,128941,128439,0,
2020-08-25,616,614,253,13,338,10,0,129557,129053,0,
2020-08-26,595,591,249,13,324,5,0,130152,129644,0,
2020-08-27,486,482,206,11,260,4,1,130638,130126,0,
2020-08-28,565,561,248,11,295,6,1,131203,130687,0,
2020-08-29,456,455,208,10,227,8,2,131659,131142,0,
2020-08-30,555,550,234,4,304,7,1,132214,131692,0,
2020-08-31,649,645,255,11,369,8,2,132863,132337,0,
2020-09-01,757,756,312,18,415,7,4,133620,133093,0,
2020-09-02,763,759,329,12,406,9,3,134383,133852,0,
2020-09-03,662,658,274,5,370,5,4,135045,134510,0,
2020-09-04,728,725,288,9,413,12,3,135773,135235,0,
2020-09-05,679,678,270,9,390,9,0,136452,135913,0,
2020-09-06,683,675,255,4,403,9,4,137135,136588,0,
2020-09-07,785,778,277,9,478,9,5,137920,137366,0,
2020-09-08,990,981,367,12,586,14,2,138910,138347,0,
2020-09-09,1026,1020,368,12,632,5,3,139936,139367,0,
2020-09-10,998,995,383,6,594,9,3,140934,140362,0,
2020-09-11,968,960,360,10,578,9,3,141902,141322,0,
2020-09-12,971,966,374,8,579,3,2,142873,142288,0,
2020-09-13,988,982,353,8,612,6,3,143861,143270,0,
2020-09-14,1271,1264,476,14,762,9,3,145132,144534,0,
2020-09-15,1339,1328,484,10,828,3,3,146471,145862,0,
2020-09-16,1349,1344,481,22,827,7,7,147820,147206,0,
2020-09-17,1300,1294,460,21,802,7,4,149120,148500,0,
2020-09-18,1420,1408,491,8,901,2,6,150540,149908,0,
2020-09-19,1273,1260,398,18,829,10,5,151813,151168,0,
2020-09-20,1354,1345,406,12,917,9,1,153167,152513,0,
2020-09-21,1833,1821,568,16,1210,7,20,155000,154334,0,
2020-09-22,1871,1852,500,13,1316,9,14,156871,156186,0,
2020-09-23,1900,1891,558,15,1303,4,11,158771,158077,0,
2020-09-24,1938,1924,511,10,1387,6,10,160709,160001,0,
2020-09-25,2033,2025,534,20,1450,8,13,162742,162026,0,
2020-09-26,1873,1860,501,7,1333,8,11,164615,163886,0,
2020-09-27,1984,1967,484,10,1452,4,17,166599,165853,0,
2020-09-28,2432,2421,603,15,1785,7,11,169031,168274,0,
2020-09-29,2266,2250,580,23,1635,5,7,171297,170524,0,
2020-09-30,2274,2263,577,16,1659,2,9,173571,172787,0,
2020-10-01,2172,2156,578,9,1549,11,9,175743,174943,0,
2020-10-02,2110,2095,545,17,1513,10,10,177853,177038,0,
2020-10-03,1813,1794,473,18,1284,9,10,179666,178832,0,
2020-10-04,1890,1861,519,14,1317,7,4,181556,180693,0,
2020-10-05,2409,2374,670,20,1670,6,8,183965,183067,0,
2020-10-06,2299,2266,682,30,1534,10,10,186264,185333,0,
2020-10-07,2279,2254,662,20,1554,8,10,188543,187587,0,
2020-10-08,2261,2230,676,14,1517,11,12,190804,189817,0,
2020-10-09,2273,2234,636,18,1561,9,10,193077,192051,0,
2020-10-10,2182,2152,652,17,1466,9,8,195259,194203,0,
2020-10-11,1923,1896,609,17,1252,6,12,197182,196099,0,
2020-10-12,2347,2315,748,19,1526,11,11,199529,198414,0,
2020-10-13,2579,2538,834,22,1661,11,10,202108,200952,0,
2020-10-14,2517,2469,887,27,1540,7,8,204625,203421,0,
2020-10-15,2552,2511,823,24,1642,13,9,207177,205932,0,
2020-10-16,2659,2618,881,19,1706,7,5,209836,208550,0,
2020-10-17,2319,2277,820,25,1413,10,9,212155,210827,0,
2020-10-18,2263,2210,805,13,1371,15,6,214418,213037,0,
2020-10-19,2979,2914,1108,22,1768,9,7,217397,215951,0,
2020-10-20,2840,2763,1077,26,1636,13,11,220237,218714,0,
2020-10-21,2840,2768,1062,33,1646,13,14,223077,221482,0,
2020-10-22,2791,2701,1053,21,1611,6,10,225868,224183,0,
2020-10-23,2818,2732,1051,31,1623,10,17,228686,226915,0,
2020-10-24,2627,2555,999,34,1503,14,5,231313,229470,0,
2020-10-25,2635,2544,1040,32,1454,12,6,233948,232014,0,
2020-10-26,3380,3281,1272,23,1967,11,8,237328,235295,0,
2020-10-27,3314,3220,1282,36,1879,13,10,240642,238515,0,
2020-10-28,3589,3483,1489,38,1931,12,13,244231,241998,0,
2020-10-29,3134,3021,1227,33,1739,9,13,247365,245019,0,
2020-10-30,3518,3408,1353,42,1996,10,7,250883,248427,0,
2020-10-31,3233,3132,1399,31,1686,12,4,254116,251559,0,
2020-11-01,3209,3126,1298,33,1780,9,6,257325,254685,0,
2020-11-02,4575,4382,1835,41,2485,13,8,261900,259067,0,
2020-11-03,4493,4340,1857,32,2417,20,14,266393,263407,0,
2020-11-04,4628,4442,1917,47,2455,9,14,271021,267849,0,
2020-11-05,4530,4330,1867,32,2405,12,14,275551,272179,0,
2020-11-06,4595,4343,1892,21,2397,14,19,280146,276522,0,
2020-11-07,4261,3878,1577,17,2256,11,17,284407,280400,0,
2020-11-08,4023,3564,1472,13,2053,9,17,288430,283964,0,
2020-11-09,5252,4587,1887,23,2645,16,16,293682,288551,0,
2020-11-10,5135,4392,1802,19,2521,15,35,298817,292943,0,
2020-11-11,4945,4364,1853,22,2457,8,24,303762,297307,0,
2020-11-12,5008,4154,1784,18,2322,11,19,308770,301461,0,
2020-11-13,5211,4318,1913,16,2352,17,20,313981,305779,0,
2020-11-14,4509,3759,1721,11,1996,13,18,318490,309538,0,
2020-11-15,4451,3595,1680,22,1854,17,22,322941,313133,0,
2020-11-16,5563,4583,2092,16,2435,20,20,328504,317716,0,
2020-11-17,5385,4406,1989,17,2362,17,21,333889,322122,0,
2020-11-18,5645,4589,2119,27,2399,11,33,339534,326711,0,
2020-11-19,5486,4404,1928,20,2396,18,42,345020,331115,0,
2020-11-20,5483,4433,1970,29,2379,14,41,350503,335548,0,
2020-11-21,5025,4058,1811,22,2164,17,44,355528,339606,0,
2020-11-22,4813,3995,1772,26,2146,21,30,360341,343601,0,
2020-11-23,6280,5242,2240,35,2878,16,73,366621,348843,0,
2020-11-24,6186,4931,2228,31,2605,10,57,372807,353774,0,
2020-11-25,6405,5249,2272,28,2852,15,82,379212,359023,0,
2020-11-26,6097,4865,2121,30,2629,18,67,385309,363888,0,
2020-11-27,6255,5056,2161,33,2784,18,60,391564,368944,0,
2020-11-28,5604,4716,2080,22,2538,16,60,397168,373660,0,
2020-11-29,5390,4397,1810,30,2493,16,48,402558,378057,0,
2020-11-30,6916,5638,2373,36,3141,19,69,409474,383695,0,
2020-12-01,6794,5619,2279,21,3254,7,58,416268,389314,0,
2020-12-02,6754,5359,2200,37,3043,14,65,423022,394673,0,
2020-12-03,6722,5442,2255,33,3066,18,70,429744,400115,0,
2020-12-04,6767,5493,2237,39,3152,10,55,436511,405608,0,
2020-12-05,5792,4804,1931,37,2780,12,44,442303,410412,0,
2020-12-06,5776,4931,1949,32,2874,30,46,448079,415343,0,
2020-12-07,7630,6368,2591,43,3650,27,57,455709,421711,0,
2020-12-08,7183,6072,2347,38,3619,16,52,462892,427783,0,
2020-12-09,6930,5791,2301,30,3373,18,69,469822,433574,0,
2020-12-10,6843,5708,2226,42,3358,22,60,476665,439282,0,
2020-12-11,6853,5846,2255,47,3440,22,82,483518,445128,0,
2020-12-12,6151,5416,1978,43,3273,27,95,489669,450544,0,
2020-12-13,5537,4879,1806,26,2943,18,86,495206,455423,0,
2020-12-14,7648,6603,2450,38,3953,26,136,502854,462026,0,
2020-12-15,7208,6919,2279,31,4461,16,132,510062,468945,0,
2020-12-16,6905,6647,2266,43,4212,10,116,516967,475592,,
2020-12-17,6629,6320,2043,35,4113,25,104,523596,481912,,
2020-12-18,6905,6660,2169,51,4286,18,136,530501,488572,,
2020-12-19,5894,5760,1837,40,3748,15,120,536395,494332,,
2020-12-20,5893,5774,1920,29,3671,21,133,542288,500106,,
2020-12-21,7604,7357,2358,39,4770,19,171,549892,507463,,
2020-12-22,7101,6884,2223,43,4411,20,187,556993,514347,,
2020-12-23,7396,7179,2413,48,4481,29,208,564389,521526,,
2020-12-24,6902,6760,2159,43,4302,14,242,571291,528286,,
2020-12-25,5664,5585,1824,51,3428,13,269,576955,533871,,
2020-12-26,7587,7388,2476,52,4497,22,341,584542,541259,,
2020-12-27,7498,7349,2596,68,4242,19,424,592040,548608,,
2020-12-28,8931,8684,2929,52,5109,27,567,600971,557292,,
2020-12-29,8149,7882,2696,71,4558,17,540,609120,565174,,
2020-12-30,7832,7542,2501,59,4321,39,622,616952,572716,,
2020-12-31,7402,7173,2429,57,3915,15,757,624354,579889,,
2021-01-01,6686,6555,2007,39,3568,28,913,631040,586444,,
2021-01-02,7420,7246,2358,67,3850,42,929,638460,593690,,
2021-01-03,7193,6995,2086,59,3741,46,1063,645653,600685,,
2021-01-04,8808,8490,2457,69,4384,30,1550,654461,609175,,
2021-01-05,7767,7511,2122,64,3706,49,1570,662228,616686,,
2021-01-06,7696,7409,1807,58,3722,52,1770,669924,624095,,
2021-01-07,6889,6618,1619,52,3291,36,1620,676813,630713,,
2021-01-08,6720,6477,1619,56,3201,39,1562,683533,637190,,
2021-01-09,5931,5779,1434,55,2921,39,1330,689464,642969,,
2021-01-10,5530,5369,1361,54,2695,30,1229,694994,648338,,
2021-01-11,6865,6523,1732,58,3121,36,1576,701859,654861,,
2021-01-12,6120,5793,1505,69,2822,29,1368,707979,660654,,
2021-01-13,6089,5865,1491,48,2853,31,1442,714068,666519,,
2021-01-14,5642,5401,1447,40,2615,27,1272,719710,671920,,
2021-01-15,5982,5692,1489,39,2833,29,1302,725692,677612,,
2021-01-16,4703,4565,1168,37,2260,19,1081,730395,682177,,
2021-01-17,4450,4319,1128,37,2131,37,986,734845,686496,,
2021-01-18,5607,5327,1407,39,2543,30,1308,740452,691823,,
2021-01-19,5217,4970,1354,48,2431,10,1127,745669,696793,,
2021-01-20,5015,4769,1333,55,2217,22,1142,750684,701562,,
2021-01-21,4766,4564,1222,29,2252,27,1034,755450,706126,,
2021-01-22,4495,4288,1210,37,2054,15,972,759945,710414,,
2021-01-23,3927,3804,1040,41,1858,16,849,763872,714218,,
2021-01-24,3469,3339,938,28,1612,13,748,767341,717557,,
2021-01-25,4601,4422,1204,36,2115,16,1051,771942,721979,,
2021-01-26,4080,3892,1016,40,1859,9,968,776022,725871,,
2021-01-27,4128,3924,1095,29,1793,14,993,780150,729795,,
2021-01-28,3807,3607,945,31,1705,16,910,783957,733402,,
2021-01-29,3727,3516,894,39,1624,14,945,787684,736918,,
2021-01-30,3096,2976,778,23,1247,9,919,790780,739894,,
2021-01-31,2803,2694,738,24,1073,18,841,793583,742588,,
2021-02-01,4051,3772,979,21,1483,17,1272,797634,746360,,
2021-02-02,3583,3295,873,33,1301,10,1078,801217,749655,,
2021-02-03,3480,3179,839,22,1247,10,1061,804697,752834,,
2021-02-04,3312,2940,832,26,1094,13,975,808009,755774,,
2021-02-05,3301,2727,803,26,886,14,998,811310,758501,,
2021-02-06,2744,2118,695,17,566,7,833,814054,760619,,
2021-02-07,2542,1727,700,23,285,12,707,816596,762346,,
2021-02-08,3358,2191,878,19,299,9,986,819954,764537,,
2021-02-09,3170,1935,756,29,272,13,865,823124,766472,,
2021-02-10,3205,2063,880,30,301,5,847,826329,768535,,
2021-02-11,2804,1843,816,25,222,7,773,829133,770378,,
2021-02-12,2933,1866,744,21,261,6,834,832066,772244,,
2021-02-13,2484,1723,694,17,267,4,741,834550,773967,,
2021-02-14,2312,1503,596,15,237,12,643,836862,775470,,
2021-02-15,2796,1718,711,31,236,8,732,839658,777188,,
2021-02-16,2772,1831,718,24,280,10,799,842430,779019,,
2021-02-17,2722,1792,727,25,258,5,777,845152,780811,,
2021-02-18,2479,1692,669,24,226,5,768,847631,782503,,
2021-02-19,2339,1634,607,18,238,5,766,849970,784137,,
2021-02-20,1615,1222,464,23,188,6,541,851585,785359,,
2021-02-21,1354,974,348,9,147,6,464,852939,786333,,
2021-02-22,1481,990,293,11,104,2,580,854420,787323,,
2021-02-23,1436,892,163,5,77,0,647,855856,788215,,
2021-02-24,695,512,50,4,35,2,421,856551,788727,,
2021-02-25,115,21,2,0,11,0,8,856666,788748,,
2021-02-26,0,0,0,0,0,0,0,856666,788748,,