date,new,NTotal_ExposureOnly,domestic-contactWithCase,domestic-contactWithTraveller,domestic-unknown,internationalTravel,infopending,cumulative,cumulativeNTotal_ExposureOnly,doubleFlagTest,shaded
2020-01-15,2,1,0,0,0,1,0,2,1,1,14
2020-01-16,5,3,1,0,2,0,0,7,4,1,
2020-01-17,1,1,0,0,0,1,0,8,5,0,
2020-01-18,0,0,0,0,0,0,0,8,5,0,
2020-01-19,0,0,0,0,0,0,0,8,5,0,
2020-01-20,1,0,0,0,0,0,0,9,5,0,
2020-01-21,4,0,0,0,0,0,0,13,5,0,
2020-01-22,6,4,1,0,1,2,0,19,9,1,
2020-01-23,0,0,0,0,0,0,0,19,9,0,
2020-01-24,3,2,0,0,0,2,0,22,11,0,
2020-01-25,3,2,1,0,1,0,0,25,13,0,
2020-01-26,2,1,1,0,0,0,0,27,14,0,
2020-01-27,8,3,2,0,1,0,0,35,17,0,
2020-01-28,7,2,1,0,0,1,0,42,19,1,
2020-01-29,2,1,0,0,0,0,1,44,20,0,
2020-01-30,3,1,1,0,0,0,0,47,21,0,
2020-01-31,2,1,0,0,1,0,0,49,22,0,
2020-02-01,7,5,3,0,1,1,0,56,27,0,
2020-02-02,3,2,0,0,1,1,0,59,29,0,
2020-02-03,1,1,0,0,1,0,0,60,30,0,
2020-02-04,2,2,0,0,2,0,0,62,32,0,
2020-02-05,3,3,1,0,1,1,0,65,35,0,
2020-02-06,0,0,0,0,0,0,0,65,35,0,
2020-02-07,0,0,0,0,0,0,0,65,35,0,
2020-02-08,1,0,0,0,0,0,0,66,35,0,
2020-02-09,1,1,0,0,0,1,0,67,36,0,
2020-02-10,2,2,0,0,1,1,0,69,38,0,
2020-02-11,2,1,0,0,1,0,0,71,39,0,
2020-02-12,4,3,2,0,1,0,0,75,42,0,
2020-02-13,1,1,0,0,0,1,0,76,43,0,
2020-02-14,6,5,0,0,3,2,0,82,48,0,
2020-02-15,3,2,1,0,0,1,0,85,50,1,
2020-02-16,1,1,0,0,0,1,0,86,51,0,
2020-02-17,2,2,1,0,0,1,0,88,53,0,
2020-02-18,2,2,2,0,0,0,0,90,55,0,
2020-02-19,4,4,2,0,1,1,0,94,59,0,
2020-02-20,9,9,3,1,3,2,0,103,68,0,
2020-02-21,3,3,0,0,1,2,0,106,71,0,
2020-02-22,8,8,2,0,3,3,0,114,79,0,
2020-02-23,22,22,11,0,3,7,1,136,101,0,
2020-02-24,15,14,3,0,2,9,0,151,115,0,
2020-02-25,16,16,4,0,2,10,0,167,131,0,
2020-02-26,14,13,6,1,4,2,0,181,144,1,
2020-02-27,27,26,12,0,7,7,0,208,170,0,
2020-02-28,39,37,17,0,6,14,0,247,207,0,
2020-02-29,27,27,8,0,7,12,0,274,234,0,
2020-03-01,60,59,12,0,26,20,1,334,293,0,
2020-03-02,56,56,8,0,18,30,0,390,349,1,
2020-03-03,55,55,15,0,12,28,0,445,404,0,
2020-03-04,62,58,13,1,14,30,0,507,462,0,
2020-03-05,67,67,12,1,23,31,0,574,529,0,
2020-03-06,86,85,17,2,26,40,0,660,614,0,
2020-03-07,91,91,14,3,30,44,0,751,705,0,
2020-03-08,135,134,27,2,45,60,0,886,839,1,
2020-03-09,224,223,44,10,79,90,0,1110,1062,0,
2020-03-10,256,254,55,9,72,118,0,1366,1316,0,
2020-03-11,296,296,74,11,85,125,1,1662,1612,0,
2020-03-12,390,389,92,9,128,159,1,2052,2001,1,
2020-03-13,464,459,124,8,151,174,2,2516,2460,0,
2020-03-14,468,466,98,15,168,183,2,2984,2926,0,
2020-03-15,607,601,152,10,212,225,2,3591,3527,0,
2020-03-16,847,838,253,10,308,266,1,4438,4365,1,
2020-03-17,873,865,260,16,320,264,5,5311,5230,0,
2020-03-18,973,965,282,19,357,303,4,6284,6195,0,
2020-03-19,811,802,253,13,297,236,3,7095,6997,0,
2020-03-20,1063,1055,363,21,423,239,9,8158,8052,0,
2020-03-21,910,895,320,8,326,237,4,9068,8947,1,
2020-03-22,873,860,320,13,340,185,2,9941,9807,0,
2020-03-23,1095,1079,464,16,417,173,9,11036,10886,0,
2020-03-24,996,986,398,21,390,173,4,12032,11872,0,
2020-03-25,1011,993,450,13,414,108,8,13043,12865,0,
2020-03-26,942,929,449,12,342,117,9,13985,13794,0,
2020-03-27,970,959,482,8,373,84,12,14955,14753,0,
2020-03-28,976,966,472,9,390,84,11,15931,15719,0,
2020-03-29,890,880,462,7,355,50,6,16821,16599,0,
2020-03-30,1183,1173,584,10,489,77,13,18004,17772,0,
2020-03-31,1009,1001,560,3,357,68,13,19013,18773,1,
2020-04-01,1326,1314,755,12,454,84,9,20339,20087,0,
2020-04-02,1195,1188,749,11,374,46,8,21534,21275,0,
2020-04-03,1339,1328,887,6,374,53,8,22873,22603,0,
2020-04-04,1173,1170,745,9,371,28,17,24046,23773,0,
2020-04-05,1080,1074,680,5,368,13,8,25126,24847,0,
2020-04-06,1442,1436,884,11,514,14,13,26568,26283,0,
2020-04-07,1310,1303,792,13,469,16,13,27878,27586,0,
2020-04-08,1408,1403,884,10,489,6,14,29286,28989,0,
2020-04-09,1508,1505,968,14,495,4,24,30794,30494,0,
2020-04-10,1812,1806,1136,19,621,6,24,32606,32300,0,
2020-04-11,1713,1710,971,11,685,4,39,34319,34010,0,
2020-04-12,1448,1445,887,16,508,7,27,35767,35455,0,
2020-04-13,2130,2128,1169,33,888,6,32,37897,37583,0,
2020-04-14,1822,1819,1094,21,669,2,33,39719,39402,1,
2020-04-15,1961,1954,1231,22,672,4,25,41680,41356,0,
2020-04-16,1965,1959,1104,19,780,1,55,43645,43315,0,
2020-04-17,1864,1858,1104,17,699,3,35,45509,45173,0,
2020-04-18,1620,1615,1041,20,524,3,27,47129,46788,0,
2020-04-19,1232,1227,743,15,454,4,11,48361,48015,0,
2020-04-20,1846,1841,1081,10,713,2,35,50207,49856,0,
2020-04-21,1412,1410,841,13,521,6,29,51619,51266,0,
2020-04-22,1571,1565,909,13,612,1,30,53190,52831,0,
2020-04-23,1585,1573,917,18,602,5,31,54775,54404,0,
2020-04-24,1540,1534,931,11,547,2,43,56315,55938,0,
2020-04-25,1406,1398,823,14,474,5,82,57721,57336,0,
2020-04-26,1319,1313,789,13,464,4,43,59040,58649,0,
2020-04-27,1657,1645,951,12,637,5,40,60697,60294,0,
2020-04-28,1538,1525,925,18,553,6,23,62235,61819,0,
2020-04-29,1479,1473,806,4,647,2,14,63714,63292,0,
2020-04-30,1474,1464,828,4,612,3,17,65188,64756,0,
2020-05-01,1594,1582,895,8,656,4,19,66782,66338,0,
2020-05-02,1072,1067,657,8,384,0,18,67854,67405,0,
2020-05-03,1024,1022,621,6,380,5,10,68878,68427,0,
2020-05-04,1366,1357,775,6,553,2,21,70244,69784,0,
2020-05-05,1302,1295,728,6,534,1,26,71546,71079,0,
2020-05-06,1128,1123,661,8,434,2,18,72674,72202,0,
2020-05-07,1179,1173,712,4,432,6,19,73853,73375,0,
2020-05-08,1185,1178,701,7,454,1,15,75038,74553,0,
2020-05-09,1026,1018,634,8,354,4,18,76064,75571,0,
2020-05-10,920,917,543,7,351,5,11,76984,76488,0,
2020-05-11,1226,1224,729,8,450,7,30,78210,77712,0,
2020-05-12,1165,1156,718,2,410,6,20,79375,78868,0,
2020-05-13,1109,1098,650,3,426,3,16,80484,79966,1,
2020-05-14,1162,1160,686,3,452,5,14,81646,81126,0,
2020-05-15,1215,1212,711,0,477,11,13,82861,82338,0,
2020-05-16,996,993,601,2,375,2,13,83857,83331,0,
2020-05-17,912,901,537,2,342,8,12,84769,84232,0,
2020-05-18,1094,1082,618,2,450,5,7,85863,85314,0,
2020-05-19,966,959,582,3,362,4,8,86829,86273,0,
2020-05-20,1126,1113,654,2,445,1,11,87955,87386,0,
2020-05-21,884,871,547,2,305,6,11,88839,88257,0,
2020-05-22,843,832,513,0,312,5,2,89682,89089,0,
2020-05-23,695,688,443,1,234,4,6,90377,89777,0,
2020-05-24,652,644,401,0,228,4,11,91029,90421,0,
2020-05-25,856,844,508,3,312,4,17,91885,91265,0,
2020-05-26,745,729,459,1,256,7,6,92630,91994,0,
2020-05-27,715,701,423,2,264,2,10,93345,92695,0,
2020-05-28,596,581,362,2,204,2,11,93941,93276,0,
2020-05-29,733,728,444,0,276,3,5,94674,94004,0,
2020-05-30,562,554,397,2,152,1,2,95236,94558,0,
2020-05-31,407,397,258,0,130,3,6,95643,94955,0,
2020-06-01,688,679,395,6,249,6,23,96331,95634,0,
2020-06-02,497,485,320,1,155,5,4,96828,96119,0,
2020-06-03,491,487,322,4,149,4,8,97319,96606,0,
2020-06-04,465,452,265,1,169,11,6,97784,97058,0,
2020-06-05,448,437,312,0,119,3,3,98232,97495,0,
2020-06-06,372,366,234,1,124,4,3,98604,97861,0,
2020-06-07,312,303,213,1,83,1,5,98916,98164,0,
2020-06-08,435,423,288,6,114,10,5,99351,98587,0,
2020-06-09,373,366,244,3,110,4,5,99724,98953,0,
2020-06-10,441,435,259,5,152,10,9,100165,99388,0,
2020-06-11,376,360,242,3,107,5,3,100541,99748,0,
2020-06-12,376,370,224,5,132,6,3,100917,100118,0,
2020-06-13,276,271,181,1,83,5,1,101193,100389,0,
2020-06-14,299,293,186,0,95,9,3,101492,100682,0,
2020-06-15,400,393,244,4,134,7,4,101892,101075,0,
2020-06-16,370,357,234,2,106,10,5,102262,101432,0,
2020-06-17,364,356,229,0,117,6,4,102626,101788,0,
2020-06-18,329,317,198,1,110,4,4,102955,102105,0,
2020-06-19,336,334,231,0,88,11,4,103291,102439,0,
2020-06-20,285,279,186,0,84,8,1,103576,102718,0,
2020-06-21,271,268,176,0,85,4,3,103847,102986,0,
2020-06-22,324,317,211,2,96,4,4,104171,103303,0,
2020-06-23,326,325,219,2,91,6,7,104497,103628,0,
2020-06-24,285,285,183,2,87,9,4,104782,103913,0,
2020-06-25,465,461,326,2,122,5,6,105247,104374,0,
2020-06-26,279,270,170,0,83,11,6,105526,104644,0,
2020-06-27,253,247,165,1,71,7,3,105779,104891,0,
2020-06-28,240,234,135,1,88,9,1,106019,105125,0,
2020-06-29,334,327,198,2,107,10,10,106353,105452,0,
2020-06-30,313,299,197,4,93,2,3,106666,105751,0,
2020-07-01,286,274,177,8,83,5,1,106952,106025,0,
2020-07-02,267,258,161,1,83,6,7,107219,106283,0,
2020-07-03,307,294,185,2,91,13,3,107526,106577,0,
2020-07-04,295,281,173,3,94,10,1,107821,106858,0,
2020-07-05,272,268,177,3,81,6,1,108093,107126,0,
2020-07-06,510,491,269,2,175,17,28,108603,107617,0,
2020-07-07,522,506,263,6,208,19,10,109125,108123,0,
2020-07-08,447,419,279,4,121,10,5,109572,108542,0,
2020-07-09,454,431,268,3,139,12,9,110026,108973,0,
2020-07-10,415,389,258,5,107,14,5,110441,109362,0,
2020-07-11,384,373,228,3,128,12,2,110825,109735,0,
2020-07-12,398,381,236,3,134,6,2,111223,110116,0,
2020-07-13,605,569,357,12,185,12,3,111828,110685,0,
2020-07-14,546,504,299,4,181,13,7,112374,111189,0,
2020-07-15,572,519,311,3,174,16,15,112946,111708,0,
2020-07-16,461,419,259,4,136,17,3,113407,112127,0,
2020-07-17,511,463,272,6,167,7,11,113918,112590,0,
2020-07-18,409,381,228,2,137,7,7,114327,112971,0,
2020-07-19,395,357,202,4,137,12,2,114722,113328,0,
2020-07-20,531,473,264,6,184,14,5,115253,113801,0,
2020-07-21,526,468,267,10,180,6,5,115779,114269,0,
2020-07-22,448,381,181,6,180,10,4,116227,114650,0,
2020-07-23,450,355,175,3,164,7,6,116677,115005,0,
2020-07-24,459,376,180,7,177,5,7,117136,115381,0,
2020-07-25,311,232,108,4,111,6,3,117447,115613,0,
2020-07-26,339,220,102,6,100,10,2,117786,115833,0,
2020-07-27,478,330,176,3,132,14,5,118264,116163,0,
2020-07-28,422,286,155,1,111,14,5,118686,116449,0,
2020-07-29,406,246,138,2,99,3,4,119092,116695,0,
2020-07-30,334,213,109,1,87,6,10,119426,116908,0,
2020-07-31,342,220,120,0,85,10,5,119768,117128,0,
2020-08-01,343,208,113,8,62,17,8,120111,117336,0,
2020-08-02,332,197,124,6,59,6,2,120443,117533,0,
2020-08-03,437,272,162,2,97,10,1,120880,117805,0,
2020-08-04,446,313,186,0,100,20,7,121326,118118,0,
2020-08-05,380,277,171,9,87,8,2,121706,118395,0,
2020-08-06,346,248,160,4,71,7,6,122052,118643,0,
2020-08-07,389,301,189,2,92,6,12,122441,118944,0,
2020-08-08,333,237,151,4,76,2,4,122774,119181,0,
2020-08-09,324,253,148,7,87,8,3,123098,119434,0,
2020-08-10,476,365,215,8,124,12,6,123574,119799,0,
2020-08-11,476,359,220,5,122,11,1,124050,120158,0,
2020-08-12,405,322,211,11,86,11,3,124455,120480,0,
2020-08-13,428,350,223,8,107,10,2,124883,120830,0,
2020-08-14,379,303,176,7,108,9,3,125262,121133,0,
2020-08-15,367,302,171,7,111,7,6,125629,121435,0,
2020-08-16,377,291,166,14,104,4,3,126006,121726,0,
2020-08-17,543,415,264,11,126,7,7,126549,122141,0,
2020-08-18,426,348,205,4,123,4,12,126975,122489,0,
2020-08-19,448,351,207,9,120,5,10,127423,122840,0,
2020-08-20,447,353,223,5,108,4,13,127870,123193,0,
2020-08-21,423,334,207,9,104,5,9,128293,123527,0,
2020-08-22,396,333,225,7,93,5,3,128689,123860,0,
2020-08-23,407,316,203,3,103,6,1,129096,124176,0,
2020-08-24,579,433,265,15,137,7,9,129675,124609,0,
2020-08-25,614,451,291,12,137,10,1,130289,125060,0,
2020-08-26,619,454,287,13,144,5,5,130908,125514,0,
2020-08-27,493,364,231,11,109,3,10,131401,125878,0,
2020-08-28,564,414,262,11,126,6,9,131965,126292,0,
2020-08-29,457,327,207,10,87,5,18,132422,126619,0,
2020-08-30,556,397,242,4,127,7,17,132978,127016,0,
2020-08-31,646,429,260,11,133,9,16,133624,127445,0,
2020-09-01,748,513,301,18,162,7,25,134372,127958,0,
2020-09-02,783,530,333,12,153,8,24,135155,128488,0,
2020-09-03,664,454,267,5,163,4,15,135819,128942,0,
2020-09-04,721,479,287,9,158,10,15,136540,129421,0,
2020-09-05,667,414,254,9,125,9,17,137207,129835,0,
2020-09-06,685,421,270,4,134,8,5,137892,130256,0,
2020-09-07,793,487,298,8,159,9,13,138685,130743,0,
2020-09-08,964,610,352,14,218,10,16,139649,131353,0,
2020-09-09,1018,627,375,12,216,4,20,140667,131980,0,
2020-09-10,1011,650,378,6,226,9,31,141678,132630,0,
2020-09-11,980,641,358,10,249,9,15,142658,133271,0,
2020-09-12,980,654,390,8,235,3,18,143638,133925,0,
2020-09-13,973,611,344,8,241,6,12,144611,134536,0,
2020-09-14,1271,803,481,14,274,7,27,145882,135339,0,
2020-09-15,1317,799,446,10,305,3,35,147199,136138,0,
2020-09-16,1361,817,494,22,272,4,25,148560,136955,0,
2020-09-17,1330,770,479,21,236,6,28,149890,137725,0,
2020-09-18,1424,804,518,8,241,1,36,151314,138529,0,
2020-09-19,1245,705,392,18,271,6,18,152559,139234,0,
2020-09-20,1365,761,420,12,283,9,37,153924,139995,0,
2020-09-21,1824,1013,559,16,376,6,56,155748,141008,0,
2020-09-22,1868,961,524,13,366,8,50,157616,141969,0,
2020-09-23,1921,1007,556,15,344,2,90,159537,142976,0,
2020-09-24,1961,985,526,10,355,2,92,161498,143961,0,
2020-09-25,2062,1060,563,20,371,9,97,163560,145021,0,
2020-09-26,1887,951,504,7,339,4,97,165447,145972,0,
2020-09-27,1976,967,478,10,352,6,121,167423,146939,0,
2020-09-28,2486,1199,625,16,422,3,133,169909,148138,0,
2020-09-29,2272,1126,551,23,406,3,143,172181,149264,0,
2020-09-30,2265,1126,563,16,435,1,111,174446,150390,0,
2020-10-01,2171,1110,584,9,414,9,94,176617,151500,0,
2020-10-02,2140,1081,547,17,404,9,104,178757,152581,0,
2020-10-03,1831,941,474,19,350,10,88,180588,153522,0,
2020-10-04,1847,922,511,14,315,4,78,182435,154444,0,
2020-10-05,2470,1267,677,20,456,4,110,184905,155711,0,
2020-10-06,2330,1264,678,31,422,10,123,187235,156975,0,
2020-10-07,2282,1262,689,20,436,9,108,189517,158237,0,
2020-10-08,2252,1192,657,14,405,10,106,191769,159429,0,
2020-10-09,2305,1249,656,18,456,7,112,194074,160678,0,
2020-10-10,2170,1340,682,17,553,7,81,196244,162018,0,
2020-10-11,1915,1119,605,17,398,5,94,198159,163137,0,
2020-10-12,2341,1338,716,19,500,8,95,200500,164475,0,
2020-10-13,2577,1523,866,22,519,9,107,203077,165998,0,
2020-10-14,2520,1522,879,26,509,7,101,205597,167520,0,
2020-10-15,2577,1420,843,24,445,9,99,208174,168940,0,
2020-10-16,2662,1598,895,19,574,4,106,210836,170538,0,
2020-10-17,2308,1385,819,25,430,6,105,213144,171923,0,
2020-10-18,2235,1381,806,13,459,12,91,215379,173304,0,
2020-10-19,2969,1887,1123,22,612,7,123,218348,175191,0,
2020-10-20,2830,1856,1098,27,570,9,152,221178,177047,0,
2020-10-21,2793,1744,1011,32,542,9,150,223971,178791,0,
2020-10-22,2798,1801,1091,21,560,2,127,226769,180592,0,
2020-10-23,2828,1817,1046,30,600,7,134,229597,182409,0,
2020-10-24,2641,1764,1036,34,532,10,152,232238,184173,0,
2020-10-25,2642,1687,1025,32,508,7,115,234880,185860,0,
2020-10-26,3387,2182,1268,23,688,10,193,238267,188042,0,
2020-10-27,3348,2227,1351,36,668,9,163,241615,190269,0,
2020-10-28,3626,2443,1430,38,767,9,199,245241,192712,0,
2020-10-29,3105,2000,1249,33,589,7,122,248346,194712,0,
2020-10-30,3532,2356,1334,43,816,9,154,251878,197068,0,
2020-10-31,3157,2166,1357,32,631,8,138,255035,199234,0,
2020-11-01,3460,2318,1387,33,742,8,148,258495,201552,0,
2020-11-02,4567,3059,1850,43,963,7,196,263062,204611,0,
2020-11-03,4501,3069,1804,34,939,15,277,267563,207680,0,
2020-11-04,4621,3086,1915,48,915,7,201,272184,210766,0,
2020-11-05,4535,3043,1759,34,961,8,281,276719,213809,0,
2020-11-06,4623,3097,1813,22,1004,11,247,281342,216906,0,
2020-11-07,4322,2874,1536,17,1101,9,211,285664,219780,0,
2020-11-08,4026,2672,1452,13,1024,8,175,289690,222452,0,
2020-11-09,5294,3563,1829,26,1446,14,248,294984,226015,0,
2020-11-10,5139,3438,1739,19,1432,14,234,300123,229453,0,
2020-11-11,4943,3422,1823,26,1349,9,215,305066,232875,0,
2020-11-12,5060,3587,1715,19,1608,12,233,310126,236462,0,
2020-11-13,5200,3726,1789,17,1675,16,229,315326,240188,0,
2020-11-14,4538,3415,1699,11,1515,13,177,319864,243603,0,
2020-11-15,4468,3321,1640,22,1493,18,148,324332,246924,0,
2020-11-16,5614,4101,2043,17,1842,22,177,329946,251025,0,
2020-11-17,5440,4010,1911,19,1816,14,250,335386,255035,0,
2020-11-18,5664,4209,2106,28,1865,12,198,341050,259244,0,
2020-11-19,5503,3987,1871,23,1865,16,212,346553,263231,0,
2020-11-20,5530,4159,1982,30,1922,15,210,352083,267390,0,
2020-11-21,5079,3802,1831,23,1764,15,169,357162,271192,0,
2020-11-22,4853,3543,1759,26,1559,22,177,362015,274735,0,
2020-11-23,6331,4593,2263,35,2037,16,242,368346,279328,0,
2020-11-24,6241,4629,2192,31,2131,11,264,374587,283957,0,
2020-11-25,6397,4701,2193,28,2149,15,316,380984,288658,0,
2020-11-26,6103,4561,2147,30,2168,17,199,387087,293219,0,
2020-11-27,6253,4549,2094,34,2185,18,218,393340,297768,0,
2020-11-28,5599,4097,2000,23,1778,15,281,398939,301865,0,
2020-11-29,5420,3866,1724,31,1863,15,233,404359,305731,0,
2020-11-30,6914,4940,2310,37,2300,21,272,411273,310671,0,
2020-12-01,6779,4825,2343,20,2196,7,259,418052,315496,0,
2020-12-02,6700,4821,2149,38,2359,13,262,424752,320317,0,
2020-12-03,6707,4724,2204,34,2176,17,293,431459,325041,0,
2020-12-04,6796,4829,2211,41,2291,10,276,438255,329870,0,
2020-12-05,5830,4101,1845,39,1955,11,251,444085,333971,0,
2020-12-06,5810,4012,1927,34,1759,31,261,449895,337983,0,
2020-12-07,7654,5309,2524,47,2365,27,346,457549,343292,0,
2020-12-08,7184,4916,2284,39,2213,17,363,464733,348208,0,
2020-12-09,6924,4762,2229,31,2106,19,377,471657,352970,0,
2020-12-10,6858,4660,2116,45,2126,24,349,478515,357630,0,
2020-12-11,6838,4710,2130,49,2153,22,356,485353,362340,0,
2020-12-12,6180,4088,1882,43,1818,24,321,491533,366428,0,
2020-12-13,5533,3666,1746,27,1594,16,283,497066,370094,0,
2020-12-14,7673,5084,2325,41,2217,29,472,504739,375178,0,
2020-12-15,7212,4786,2143,33,2162,17,431,511951,379964,0,
2020-12-16,6882,4561,2107,46,1968,9,431,518833,384525,0,
2020-12-17,6649,4332,1908,36,1940,27,421,525482,388857,0,
2020-12-18,6915,4532,2027,53,1999,20,433,532397,393389,0,
2020-12-19,5912,3729,1780,41,1585,17,306,538309,397118,0,
2020-12-20,5903,3768,1846,29,1568,20,305,544212,400886,0,
2020-12-21,7569,4704,2234,41,1939,16,474,551781,405590,0,
2020-12-22,7139,4394,2173,44,1732,22,423,558920,409984,0,
2020-12-23,7393,4621,2289,49,1805,30,448,566313,414605,0,
2020-12-24,6894,4422,2144,44,1807,14,413,573207,419027,0,
2020-12-25,5720,3517,1848,51,1326,15,277,578927,422544,0,
2020-12-26,7606,4998,2591,58,1976,25,348,586533,427542,0,
2020-12-27,7577,4944,2697,69,1783,20,375,594110,432486,0,
2020-12-28,8946,5767,3041,52,2192,25,457,603056,438253,0,
2020-12-29,8170,5301,2851,72,1910,16,452,611226,443554,0,
2020-12-30,7879,5017,2681,59,1770,41,466,619105,448571,0,
2020-12-31,7466,4937,2628,57,1803,16,433,626571,453508,0,
2021-01-01,7126,4484,2402,40,1648,29,365,633697,457992,0,
2021-01-02,7542,5103,2779,69,1768,44,443,641239,463095,0,
2021-01-03,7343,4751,2580,61,1669,50,391,648582,467846,0,
2021-01-04,8940,5827,3128,69,2042,32,556,657522,473673,0,
2021-01-05,7835,5140,2827,64,1716,52,481,665357,478813,0,
2021-01-06,7742,5011,2676,60,1662,53,560,673099,483824,0,
2021-01-07,6892,4451,2394,52,1474,38,493,679991,488275,0,
2021-01-08,6761,4440,2376,58,1472,39,495,686752,492715,0,
2021-01-09,5981,3883,2082,54,1301,40,406,692733,496598,0,
2021-01-10,5573,3674,1962,58,1247,29,378,698306,500272,0,
2021-01-11,6874,4594,2524,59,1474,36,501,705180,504866,0,
2021-01-12,6080,4025,2188,71,1286,30,450,711260,508891,0,
2021-01-13,6083,4030,2123,49,1344,32,482,717343,512921,0,
2021-01-14,5647,3833,2099,44,1217,28,445,722990,516754,0,
2021-01-15,6004,3896,2092,40,1334,30,400,728994,520650,0,
2021-01-16,4708,3167,1696,37,1122,20,292,733702,523817,0,
2021-01-17,4472,2985,1598,38,983,37,329,738174,526802,0,
2021-01-18,5656,3784,2017,39,1220,31,477,743830,530586,0,
2021-01-19,5224,3475,1849,48,1110,12,456,749054,534061,0,
2021-01-20,5048,3379,1851,56,1082,24,366,754102,537440,0,
2021-01-21,4765,3186,1709,28,1027,26,396,758867,540626,0,
2021-01-22,4507,3065,1681,39,1016,18,311,763374,543691,0,
2021-01-23,3945,2663,1447,43,872,15,286,767319,546354,0,
2021-01-24,3500,2345,1271,27,789,11,247,770819,548699,0,
2021-01-25,4629,3022,1625,37,948,18,394,775448,551721,0,
2021-01-26,4093,2662,1434,40,832,10,346,779541,554383,0,
2021-01-27,4195,2793,1543,28,887,15,320,783736,557176,0,
2021-01-28,3876,2501,1342,30,845,17,267,787612,559677,0,
2021-01-29,3763,2442,1307,40,850,14,231,791375,562119,0,
2021-01-30,3154,2082,1088,23,732,10,229,794529,564201,0,
2021-01-31,2876,1890,1069,24,603,18,176,797405,566091,0,
2021-02-01,4114,2697,1387,21,895,15,379,801519,568788,0,
2021-02-02,3617,2358,1286,32,779,11,250,805136,571146,0,
2021-02-03,3536,2295,1243,22,780,10,240,808672,573441,0,
2021-02-04,3348,2186,1176,26,727,14,243,812020,575627,0,
2021-02-05,3364,2209,1160,26,766,16,241,815384,577836,0,
2021-02-06,2791,1871,1044,18,671,7,131,818175,579707,0,
2021-02-07,2643,1738,973,24,592,12,137,820818,581445,0,
2021-02-08,3506,2284,1289,19,742,9,225,824324,583729,0,
2021-02-09,3228,2025,1125,29,680,13,178,827552,585754,0,
2021-02-10,3291,2181,1274,28,739,5,135,830843,587935,0,
2021-02-11,2893,1933,1169,23,599,7,135,833736,589868,0,
2021-02-12,3117,2065,1187,21,678,7,172,836853,591933,0,
2021-02-13,2676,1876,1125,17,575,4,155,839529,593809,0,
2021-02-14,2533,1706,1027,16,550,20,93,842062,595515,0,
2021-02-15,3048,2011,1214,33,631,7,126,845110,597526,0,
2021-02-16,3010,2092,1256,27,635,13,161,848120,599618,0,
2021-02-17,3104,2139,1303,29,628,8,171,851224,601757,0,
2021-02-18,3023,2115,1272,31,605,7,200,854247,603872,0,
2021-02-19,2995,2090,1238,24,657,5,166,857242,605962,0,
2021-02-20,2735,1886,1131,25,598,10,122,859977,607848,0,
2021-02-21,2530,1798,1049,14,599,10,126,862507,609646,0,
2021-02-22,3211,2224,1318,15,691,6,194,865718,611870,0,
2021-02-23,3017,2152,1312,11,672,4,153,868735,614022,0,
2021-02-24,3112,2158,1333,18,634,7,166,871847,616180,0,
2021-02-25,2840,2019,1229,16,620,4,150,874687,618199,0,
2021-02-26,2938,2102,1302,19,611,10,160,877625,620301,0,
2021-02-27,2710,2006,1224,11,601,15,155,880335,622307,0,
2021-02-28,2654,1961,1198,21,592,9,141,882989,624268,0,
2021-03-01,3522,2545,1498,19,807,7,214,886511,626813,0,
2021-03-02,3122,2292,1415,22,675,7,173,889633,629105,0,
2021-03-03,3297,2382,1479,19,713,15,156,892930,631487,0,
2021-03-04,2892,2179,1322,22,673,16,146,895822,633666,0,
2021-03-05,3220,2404,1520,21,692,4,167,899042,636070,0,
2021-03-06,2821,2120,1309,5,638,12,156,901863,638190,0,
2021-03-07,2700,2022,1211,13,660,9,129,904563,640212,0,
2021-03-08,3558,2675,1638,13,798,20,206,908121,642887,0,
2021-03-09,3364,2580,1592,24,749,11,204,911485,645467,0,
2021-03-10,3685,2809,1737,22,802,18,230,915170,648276,0,
2021-03-11,3298,2482,1526,14,723,18,201,918468,650758,0,
2021-03-12,3406,2623,1585,10,783,15,230,921874,653381,0,
2021-03-13,3172,2438,1539,10,720,10,159,925046,655819,0,
2021-03-14,3067,2295,1394,11,712,25,153,928113,658114,0,
2021-03-15,4166,3325,2021,12,1046,17,229,932279,661439,0,
2021-03-16,4015,3131,1946,11,936,13,225,936294,664570,0,
2021-03-17,4410,3535,2255,9,1033,21,217,940704,668105,0,
2021-03-18,4010,3188,2053,12,906,17,200,944714,671293,0,
2021-03-19,4359,3435,2095,12,1072,20,236,949073,674728,0,
2021-03-20,4192,3320,2019,12,1078,8,203,953265,678048,0,
2021-03-21,4205,3335,1982,16,1085,31,221,957470,681383,0,
2021-03-22,5342,4155,2473,20,1363,13,286,962812,685538,0,
2021-03-23,5582,4344,2517,24,1467,24,312,968394,689882,0,
2021-03-24,5623,4490,2717,21,1410,30,312,974017,694372,0,
2021-03-25,5232,4089,2419,17,1330,19,304,979249,698461,0,
2021-03-26,5690,4504,2660,22,1439,25,358,984939,702965,0,
2021-03-27,5383,4239,2508,22,1427,13,269,990322,707204,0,
2021-03-28,5444,4253,2509,17,1416,30,281,995766,711457,0,
2021-03-29,6692,5303,3112,14,1791,23,363,1002458,716760,0,
2021-03-30,6740,5281,3129,21,1749,31,351,1009198,722041,0,
2021-03-31,6822,5430,3200,30,1827,19,354,1016020,727471,0,
2021-04-01,7871,6363,3573,37,2169,19,565,1023891,733834,0,
2021-04-02,7169,5708,3362,34,1847,18,447,1031060,739542,0,
2021-04-03,7167,5669,3352,32,1749,16,520,1038227,745211,0,
2021-04-04,7408,5893,3432,29,1938,22,472,1045635,751104,0,
2021-04-05,9598,7717,4397,39,2584,34,663,1055233,758821,0,
2021-04-06,9618,7748,4470,49,2496,25,708,1064851,766569,0,
2021-04-07,9640,7786,4488,42,2514,27,715,1074491,774355,0,
2021-04-08,9006,7278,4130,38,2339,22,749,1083497,781633,0,
2021-04-09,9026,7267,4001,40,2429,42,755,1092523,788900,0,
2021-04-10,8567,7022,3888,41,2348,32,713,1101090,795922,0,
2021-04-11,7829,6355,3511,32,2159,29,624,1108919,802277,0,
2021-04-12,9300,7509,4294,40,2348,36,791,1118219,809786,0,
2021-04-13,8667,7084,4014,31,2266,29,744,1126886,816870,0,
2021-04-14,8810,7228,4071,38,2237,34,848,1135696,824098,0,
2021-04-15,8092,6702,3819,29,2052,20,782,1143788,830800,0,
2021-04-16,8307,6933,3899,23,2294,28,689,1152095,837733,0,
2021-04-17,7898,6600,3760,36,2076,26,702,1159993,844333,0,
2021-04-18,7210,6070,3409,26,1971,34,630,1167203,850403,0,
2021-04-19,8765,7361,4159,34,2340,44,784,1175968,857764,0,
2021-04-20,8291,6984,4090,27,2166,32,669,1184259,864748,0,
2021-04-21,8202,6996,4064,28,2200,56,648,1192461,871744,0,
2021-04-22,7650,6493,3761,18,2068,58,588,1200111,878237,0,
2021-04-23,8080,6937,3997,33,2152,51,704,1208191,885174,0,
2021-04-24,7291,6149,3605,22,1935,23,564,1215482,891323,0,
2021-04-25,6770,5698,3372,21,1803,33,469,1222252,897021,0,
2021-04-26,8220,6955,4064,27,2168,45,651,1230472,903976,0,
2021-04-27,7655,6491,3881,21,1943,19,627,1238127,910467,0,
2021-04-28,8136,6891,4040,27,2107,20,697,1246263,917358,0,
2021-04-29,7139,6028,3595,24,1774,11,624,1253402,923386,0,
2021-04-30,7398,6305,3690,24,1880,37,674,1260800,929691,0,
2021-05-01,7046,6071,3579,18,1954,12,508,1267846,935762,0,
2021-05-02,6128,5259,3221,27,1563,12,436,1273974,941021,0,
2021-05-03,7537,6393,3865,26,2001,19,482,1281511,947414,0,
2021-05-04,6885,5804,3622,22,1745,25,390,1288396,953218,0,
2021-05-05,6764,5767,3548,27,1782,21,389,1295160,958985,0,
2021-05-06,6186,5178,3206,11,1570,14,377,1301346,964163,0,
2021-05-07,6295,5277,3266,19,1631,22,339,1307641,969440,0,
2021-05-08,5631,4745,2941,25,1483,10,286,1313272,974185,0,
2021-05-09,5020,4237,2692,20,1308,5,212,1318292,978422,0,
2021-05-10,6326,5251,3191,26,1654,19,361,1324618,983673,0,
2021-05-11,5501,4562,2808,26,1399,6,323,1330119,988235,0,
2021-05-12,5457,4551,2820,19,1444,7,261,1335576,992786,0,
2021-05-13,4977,4121,2603,19,1251,12,236,1340553,996907,0,
2021-05-14,4898,4060,2467,11,1295,10,277,1345451,1000967,0,
2021-05-15,4305,3555,2173,9,1137,9,227,1349756,1004522,0,
2021-05-16,3817,3136,1889,6,1059,11,171,1353573,1007658,0,
2021-05-17,4543,3717,2246,9,1145,13,304,1358116,1011375,0,
2021-05-18,4089,3298,1974,11,1041,7,265,1362205,1014673,0,
2021-05-19,3703,3004,1853,14,941,4,192,1365908,1017677,0,
2021-05-20,3486,2829,1708,8,866,7,240,1369394,1020506,0,
2021-05-21,3264,2643,1607,7,806,8,215,1372658,1023149,0,
2021-05-22,2655,2178,1332,8,700,4,134,1375313,1025327,0,
2021-05-23,2324,1862,1127,1,617,3,114,1377637,1027189,0,
2021-05-24,2421,1943,1178,6,640,2,117,1380058,1029132,0,
2021-05-25,2695,2156,1365,1,648,6,136,1382753,1031288,0,
2021-05-26,2417,1932,1231,7,586,4,104,1385170,1033220,0,
2021-05-27,2243,1809,1175,6,531,5,92,1387413,1035029,0,
2021-05-28,2102,1688,1093,8,493,6,88,1389515,1036717,0,
2021-05-29,1692,1350,842,1,427,7,73,1391207,1038067,0,
2021-05-30,1548,1247,812,6,372,7,50,1392755,1039314,0,
2021-05-31,1979,1589,1056,1,454,6,72,1394734,1040903,0,
2021-06-01,1853,1515,943,8,469,9,86,1396587,1042418,0,
2021-06-02,1736,1393,916,3,415,2,57,1398323,1043811,0,
2021-06-03,1511,1221,804,5,345,4,63,1399834,1045032,0,
2021-06-04,1494,1173,754,3,346,5,65,1401328,1046205,0,
2021-06-05,1230,996,650,3,295,5,43,1402558,1047201,0,
2021-06-06,1098,875,581,0,256,3,35,1403656,1048076,0,
2021-06-07,1455,1146,769,3,318,5,51,1405111,1049222,0,
2021-06-08,1215,952,599,2,289,8,54,1406326,1050174,0,
2021-06-09,1214,961,650,6,232,6,67,1407540,1051135,0,
2021-06-10,1189,924,644,6,212,9,53,1408729,1052059,0,
2021-06-11,1061,817,529,1,225,9,53,1409790,1052876,0,
2021-06-12,919,714,458,4,186,9,57,1410709,1053590,0,
2021-06-13,769,610,378,2,183,3,44,1411478,1054200,0,
2021-06-14,1052,791,521,3,218,12,37,1412530,1054991,0,
2021-06-15,921,696,477,0,186,6,27,1413451,1055687,0,
2021-06-16,860,650,435,1,162,11,41,1414311,1056337,0,
2021-06-17,720,545,368,2,144,6,25,1415031,1056882,0,
2021-06-18,730,569,373,3,146,16,31,1415761,1057451,0,
2021-06-19,573,453,267,0,142,6,38,1416334,1057904,0,
2021-06-20,571,425,255,3,134,5,28,1416905,1058329,0,
2021-06-21,703,553,334,1,164,9,45,1417608,1058882,0,
2021-06-22,669,502,306,2,146,6,42,1418277,1059384,0,
2021-06-23,672,495,316,1,143,4,31,1418949,1059879,0,
2021-06-24,586,455,274,4,132,11,34,1419535,1060334,0,
2021-06-25,547,417,262,3,113,6,33,1420082,1060751,0,
2021-06-26,477,354,212,3,110,7,22,1420559,1061105,0,
2021-06-27,437,319,184,1,99,4,31,1420996,1061424,0,
2021-06-28,562,415,243,1,122,9,40,1421558,1061839,0,
2021-06-29,495,350,174,2,117,12,45,1422053,1062189,0,
2021-06-30,487,386,217,4,109,11,45,1422540,1062575,0,
2021-07-01,417,294,167,3,93,11,20,1422957,1062869,0,
2021-07-02,442,319,173,0,102,4,40,1423399,1063188,0,
2021-07-03,434,331,182,2,116,11,20,1423833,1063519,0,
2021-07-04,408,301,161,2,113,3,22,1424241,1063820,0,
2021-07-05,532,366,214,3,119,5,25,1424773,1064186,0,
2021-07-06,498,359,211,4,117,9,18,1425271,1064545,0,
2021-07-07,432,310,172,4,108,10,16,1425703,1064855,0,
2021-07-08,360,253,140,3,87,9,14,1426063,1065108,0,
2021-07-09,384,273,135,2,99,13,24,1426447,1065381,,
2021-07-10,357,265,141,2,100,13,9,1426804,1065646,,
2021-07-11,347,245,127,0,91,12,15,1427151,1065891,,
2021-07-12,479,366,192,1,140,12,21,1427630,1066257,,
2021-07-13,444,312,160,0,119,8,25,1428074,1066569,,
2021-07-14,498,337,177,0,122,17,21,1428572,1066906,,
2021-07-15,436,307,157,1,116,16,17,1429008,1067213,,
2021-07-16,475,351,183,6,126,16,20,1429483,1067564,,
2021-07-17,416,303,157,7,116,14,9,1429899,1067867,,
2021-07-18,500,358,174,7,145,16,16,1430399,1068225,,
2021-07-19,626,466,226,4,206,16,14,1431025,1068691,,
2021-07-20,704,524,259,10,230,12,13,1431729,1069215,,
2021-07-21,684,510,241,5,235,18,11,1432413,1069725,,
2021-07-22,627,453,231,9,186,14,13,1433040,1070178,,
2021-07-23,688,525,272,4,199,16,34,1433728,1070703,,
2021-07-24,646,496,290,4,177,14,11,1434374,1071199,,
2021-07-25,753,576,296,11,237,18,14,1435127,1071775,,
2021-07-26,1031,795,408,6,333,24,24,1436158,1072570,,
2021-07-27,972,740,405,10,291,11,23,1437130,1073310,,
2021-07-28,977,724,381,10,284,25,24,1438107,1074034,,
2021-07-29,960,699,365,11,285,20,18,1439067,1074733,,
2021-07-30,961,692,370,12,264,17,29,1440028,1075425,,
2021-07-31,991,759,374,9,327,24,25,1441019,1076184,,
2021-08-01,1192,899,479,18,353,24,25,1442211,1077083,,
2021-08-02,1534,1076,489,19,507,27,34,1443745,1078159,,
2021-08-03,1773,1283,630,17,549,27,60,1445518,1079442,,
2021-08-04,1735,1246,603,21,554,18,50,1447253,1080688,,
2021-08-05,1706,1180,612,15,497,23,33,1448959,1081868,,
2021-08-06,1657,1109,539,13,485,21,51,1450616,1082977,,
2021-08-07,1698,1250,632,11,537,25,45,1452314,1084227,,
2021-08-08,1777,1293,667,23,540,20,43,1454091,1085520,,
2021-08-09,2228,1623,818,23,701,20,61,1456319,1087143,,
2021-08-10,2430,1789,855,27,793,40,74,1458749,1088932,,
2021-08-11,2347,1712,831,28,765,24,64,1461096,1090644,,
2021-08-12,2111,1542,763,26,667,35,51,1463207,1092186,,
2021-08-13,2132,1548,786,15,647,38,62,1465339,1093734,,
2021-08-14,2184,1637,841,25,686,27,58,1467523,1095371,,
2021-08-15,2267,1662,851,23,722,16,50,1469790,1097033,,
2021-08-16,3037,2253,1066,31,1049,31,76,1472827,1099286,,
2021-08-17,2999,2192,1071,31,984,28,78,1475826,1101478,,
2021-08-18,2989,2189,1046,35,1004,22,82,1478815,1103667,,
2021-08-19,2744,1986,967,18,904,27,70,1481559,1105653,,
2021-08-20,2862,2150,1014,22,1015,19,80,1484421,1107803,,
2021-08-21,2736,2097,949,15,1030,23,80,1487157,1109900,,
2021-08-22,2924,2217,938,21,1170,24,64,1490081,1112117,,
2021-08-23,3737,2755,1061,13,1555,30,96,1493818,1114872,,
2021-08-24,3761,2773,1034,8,1611,29,91,1497579,1117645,,
2021-08-25,3737,2718,975,7,1633,18,85,1501316,1120363,,
2021-08-26,3375,2480,950,5,1427,19,79,1504691,1122843,,
2021-08-27,3647,2622,913,6,1574,18,111,1508338,1125465,,
2021-08-28,3293,2457,912,8,1439,26,72,1511631,1127922,,
2021-08-29,3261,2417,838,6,1476,21,76,1514892,1130339,,
2021-08-30,4085,2919,1029,11,1772,22,85,1518977,1133258,,
2021-08-31,4056,2878,935,10,1831,16,86,1523033,1136136,,
2021-09-01,4453,3201,1090,6,1991,19,95,1527486,1139337,,
2021-09-02,3901,2810,998,4,1717,14,77,1531387,1142147,,
2021-09-03,4175,3032,1059,7,1848,24,94,1535562,1145179,,
2021-09-04,3645,2720,930,6,1718,17,49,1539207,1147899,,
2021-09-05,3583,2614,862,5,1683,9,55,1542790,1150513,,
2021-09-06,4031,2948,975,8,1874,10,81,1546821,1153461,,
2021-09-07,4871,3433,1179,4,2129,11,110,1551692,1156894,,
2021-09-08,4813,3367,1151,6,2110,16,84,1556505,1160261,,
2021-09-09,4445,3080,1050,6,1919,23,82,1560950,1163341,,
2021-09-10,4507,3178,1080,10,2015,10,63,1565457,1166519,,
2021-09-11,3797,2750,933,5,1728,10,74,1569254,1169269,,
2021-09-12,3751,2703,952,4,1663,11,73,1573005,1171972,,
2021-09-13,4989,3420,1180,6,2137,13,84,1577994,1175392,,
2021-09-14,4586,3213,1109,8,1966,22,108,1582580,1178605,,
2021-09-15,4563,3231,1156,7,1954,14,100,1587143,1181836,,
2021-09-16,4270,3078,1133,1,1847,8,89,1591413,1184914,,
2021-09-17,4437,3122,1139,3,1865,7,108,1595850,1188036,,
2021-09-18,3804,2787,1035,3,1656,15,78,1599654,1190823,,
2021-09-19,3652,2732,941,12,1697,8,74,1603306,1193555,,
2021-09-20,4904,3580,1313,4,2143,13,107,1608210,1197135,,
2021-09-21,4555,3276,1181,5,1988,11,91,1612765,1200411,,
2021-09-22,4326,3223,1236,7,1887,10,83,1617091,1203634,,
2021-09-23,4131,3002,1198,4,1714,17,69,1621222,1206636,,
2021-09-24,4216,3147,1173,8,1848,7,111,1625438,1209783,,
2021-09-25,3481,2665,1008,3,1583,6,65,1628919,1212448,,
2021-09-26,3583,2741,1043,6,1616,12,64,1632502,1215189,,
2021-09-27,4410,3190,1225,7,1859,12,87,1636912,1218379,,
2021-09-28,3788,2726,1078,7,1553,14,74,1640700,1221105,,
2021-09-29,3906,2840,1147,3,1602,18,70,1644606,1223945,,
2021-09-30,3273,2467,954,3,1445,9,56,1647879,1226412,,
2021-10-01,3656,2608,1031,0,1491,13,73,1651535,1229020,,
2021-10-02,2938,2169,898,2,1205,10,54,1654473,1231189,,
2021-10-03,2840,2042,870,4,1099,15,54,1657313,1233231,,
2021-10-04,3723,2585,1044,6,1452,14,69,1661036,1235816,,
2021-10-05,3428,2342,993,4,1264,8,73,1664464,1238158,,
2021-10-06,3253,2247,988,4,1192,5,58,1667717,1240405,,
2021-10-07,2935,1992,864,3,1041,8,76,1670652,1242397,,
2021-10-08,3091,2093,848,5,1163,11,66,1673743,1244490,,
2021-10-09,2644,1847,792,2,991,9,53,1676387,1246337,,
2021-10-10,2369,1710,743,2,907,9,49,1678756,1248047,,
2021-10-11,2599,1791,755,2,968,15,51,1681355,1249838,,
2021-10-12,3056,2064,867,2,1110,14,71,1684411,1251902,,
2021-10-13,2963,1969,896,0,1013,12,48,1687374,1253871,,
2021-10-14,2684,1838,781,4,992,11,50,1690058,1255709,,
2021-10-15,2606,1804,770,2,963,10,59,1692664,1257513,,
2021-10-16,2202,1602,698,0,855,10,39,1694866,1259115,,
2021-10-17,2112,1525,663,2,803,10,47,1696978,1260640,,
2021-10-18,2631,1834,822,1,939,14,58,1699609,1262474,,
2021-10-19,2321,1575,690,2,818,13,52,1701930,1264049,,
2021-10-20,2420,1668,748,4,852,7,57,1704350,1265717,,
2021-10-21,2244,1522,718,0,735,10,59,1706594,1267239,,
2021-10-22,2245,1591,706,4,819,4,58,1708839,1268830,,
2021-10-23,1862,1307,577,2,669,5,54,1710701,1270137,,
2021-10-24,1966,1401,605,2,738,9,47,1712667,1271538,,
2021-10-25,2468,1697,776,2,851,21,47,1715135,1273235,,
2021-10-26,2284,1572,724,1,764,17,66,1717419,1274807,,
2021-10-27,2285,1551,715,3,770,12,51,1719704,1276358,,
2021-10-28,2213,1480,697,1,709,9,64,1721917,1277838,,
2021-10-29,2215,1393,632,5,681,7,68,1724132,1279231,,
2021-10-30,1990,1331,627,1,636,16,51,1726122,1280562,,
2021-10-31,2034,1394,683,0,628,13,70,1728156,1281956,,
2021-11-01,2818,1949,878,4,953,11,103,1730974,1283905,,
2021-11-02,2678,1858,898,2,864,16,78,1733652,1285763,,
2021-11-03,2613,1885,877,1,877,22,108,1736265,1287648,,
2021-11-04,2526,1756,873,5,772,13,93,1738791,1289404,,
2021-11-05,2567,1758,866,3,777,16,96,1741358,1291162,,
2021-11-06,2347,1659,836,3,716,22,82,1743705,1292821,,
2021-11-07,2139,1436,708,2,627,14,85,1745844,1294257,,
2021-11-08,2747,1782,893,13,765,23,88,1748591,1296039,,
2021-11-09,2517,1621,873,7,638,20,83,1751108,1297660,,
2021-11-10,2616,1755,906,6,711,13,119,1753724,1299415,,
2021-11-11,2218,1468,739,2,630,20,77,1755942,1300883,,
2021-11-12,2428,1578,842,8,613,15,100,1758370,1302461,,
2021-11-13,2130,1457,794,4,576,10,73,1760500,1303918,,
2021-11-14,2166,1426,712,3,629,24,58,1762666,1305344,,
2021-11-15,2679,1738,957,4,679,15,83,1765345,1307082,,
2021-11-16,2535,1644,852,5,631,31,125,1767880,1308726,,
2021-11-17,2693,1743,880,1,718,31,113,1770573,1310469,,
2021-11-18,2388,1501,819,3,556,22,101,1772961,1311970,,
2021-11-19,2561,1618,827,3,645,25,118,1775522,1313588,,
2021-11-20,2266,1359,718,5,509,30,97,1777788,1314947,,
2021-11-21,2380,1469,786,5,576,18,84,1780168,1316416,,
2021-11-22,3100,1881,1012,2,699,28,140,1783268,1318297,,
2021-11-23,2891,1774,979,2,636,33,124,1786159,1320071,,
2021-11-24,2914,1755,949,6,643,23,134,1789073,1321826,,
2021-11-25,2629,1581,863,0,588,30,100,1791702,1323407,,
2021-11-26,2863,1689,875,5,616,22,171,1794565,1325096,,
2021-11-27,2525,1568,849,1,553,35,130,1797090,1326664,,
2021-11-28,2774,1619,853,1,564,45,156,1799864,1328283,,
2021-11-29,3466,1982,1023,2,723,63,171,1803330,1330265,,
2021-11-30,3315,1874,957,2,695,34,186,1806645,1332139,,
2021-12-01,3631,2039,1104,4,695,35,201,1810276,1334178,,
2021-12-02,3334,1896,953,4,666,39,234,1813610,1336074,,
2021-12-03,3691,2135,1100,5,735,37,258,1817301,1338209,,
2021-12-04,3106,1725,892,5,613,40,175,1820407,1339934,,
2021-12-05,3376,1940,1023,6,662,42,207,1823783,1341874,,
2021-12-06,4594,2619,1389,7,844,45,334,1828377,1344493,,
2021-12-07,4718,2670,1445,5,787,51,382,1833095,1347163,,
2021-12-08,4815,2807,1452,6,848,43,458,1837910,1349970,,
2021-12-09,4622,2565,1261,10,749,50,495,1842532,1352535,,
2021-12-10,5076,2942,1396,6,784,66,690,1847608,1355477,,
2021-12-11,4998,2976,1232,12,871,69,792,1852606,1358453,,
2021-12-12,6182,3714,1349,11,1058,77,1219,1858788,1362167,,
2021-12-13,9525,5632,1813,10,1491,122,2196,1868313,1367799,,
2021-12-14,9956,5762,1771,19,1459,103,2410,1878269,1373561,,
2021-12-15,10682,5996,1657,26,1336,90,2887,1888951,1379557,,
2021-12-16,11266,6167,1571,17,1242,99,3238,1900217,1385724,,
2021-12-17,14111,7803,1752,12,1652,118,4269,1914328,1393527,,
2021-12-18,14729,8380,1743,13,1777,104,4743,1929057,1401907,,
2021-12-19,18246,10245,1790,18,2499,111,5827,1947303,1412152,,
2021-12-20,28745,15726,2287,19,3610,136,9674,1976048,1427878,,
2021-12-21,30469,15743,2219,12,3387,106,10019,2006517,1443621,,
2021-12-22,30214,14764,1888,15,2829,99,9933,2036731,1458385,,
2021-12-23,30123,15231,1742,10,2698,68,10713,2066854,1473616,,
2021-12-24,26572,14096,1641,10,2595,76,9774,2093426,1487712,,
2021-12-25,21634,10300,1724,9,2472,68,6027,2115060,1498012,,
2021-12-26,29200,14621,2322,13,3315,61,8910,2144260,1512633,,
2021-12-27,40064,20949,2630,20,3339,78,14882,2184324,1533582,,
2021-12-28,46891,23422,2364,12,2688,63,18295,2231215,1557004,,
2021-12-29,48674,24182,1913,5,2496,49,19719,2279889,1581186,,
2021-12-30,46144,23464,1535,14,2051,55,19809,2326033,1604650,,
2021-12-31,34410,15075,1241,7,1793,47,11987,2360443,1619725,,
2022-01-01,22605,8470,1025,9,1748,37,5651,2383048,1628195,,
2022-01-02,27635,10704,1134,10,1947,37,7576,2410683,1638899,,
2022-01-03,37851,13172,1275,15,2035,42,9805,2448534,1652071,,
2022-01-04,36460,12560,1021,5,1757,42,9735,2484994,1664631,,
2022-01-05,32024,10650,822,6,1551,34,8237,2517018,1675281,,
2022-01-06,23759,9008,609,3,1126,24,7246,2540777,1684289,,
2022-01-07,20136,7253,388,4,735,10,6116,2560913,1691542,,
2022-01-08,11253,4412,184,0,314,8,3906,2572166,1695954,,
2022-01-09,9373,3796,106,0,150,1,3539,2581539,1699750,,
2022-01-10,8283,4799,77,0,85,0,4637,2589822,1704549,,
2022-01-11,3287,2151,19,0,6,0,2126,2593109,1706700,,
2022-01-12,113,79,1,0,0,0,78,2593222,1706779,,