date,new,NTotal_ExposureOnly,domestic-contactWithCase,domestic-contactWithTraveller,domestic-unknown,internationalTravel,infopending,cumulative,cumulativeNTotal_ExposureOnly,doubleFlagTest,shaded
2020-01-15,2,1,0,0,0,1,0,2,1,1,14
2020-01-16,5,5,1,0,4,0,0,7,6,1,
2020-01-17,1,1,0,0,0,1,0,8,7,0,
2020-01-18,0,0,0,0,0,0,0,8,7,0,
2020-01-19,0,0,0,0,0,0,0,8,7,0,
2020-01-20,1,0,0,0,0,0,0,9,7,0,
2020-01-21,4,3,0,0,3,0,0,13,10,0,
2020-01-22,5,5,1,0,2,2,0,18,15,1,
2020-01-23,0,0,0,0,0,0,0,18,15,0,
2020-01-24,3,3,0,0,1,2,0,21,18,0,
2020-01-25,4,4,2,0,2,0,0,25,22,0,
2020-01-26,2,2,1,0,1,0,0,27,24,0,
2020-01-27,7,6,2,0,4,0,0,34,30,0,
2020-01-28,5,4,0,0,3,1,0,39,34,1,
2020-01-29,1,1,0,0,1,0,0,40,35,0,
2020-01-30,2,1,1,0,0,0,0,42,36,0,
2020-01-31,2,1,0,0,1,0,0,44,37,0,
2020-02-01,5,5,3,0,1,1,0,49,42,0,
2020-02-02,3,3,0,0,2,1,0,52,45,0,
2020-02-03,1,1,0,0,1,0,0,53,46,0,
2020-02-04,2,2,0,0,2,0,0,55,48,0,
2020-02-05,3,3,1,0,1,1,0,58,51,0,
2020-02-06,0,0,0,0,0,0,0,58,51,0,
2020-02-07,0,0,0,0,0,0,0,58,51,0,
2020-02-08,1,0,0,0,0,0,0,59,51,0,
2020-02-09,1,1,0,0,0,1,0,60,52,0,
2020-02-10,2,2,0,0,1,1,0,62,54,0,
2020-02-11,2,2,0,0,2,0,0,64,56,0,
2020-02-12,4,3,2,0,1,0,0,68,59,0,
2020-02-13,1,1,0,0,0,1,0,69,60,0,
2020-02-14,6,5,0,0,3,2,0,75,65,0,
2020-02-15,3,2,1,0,0,1,0,78,67,1,
2020-02-16,1,1,0,0,0,1,0,79,68,0,
2020-02-17,2,2,1,0,0,1,0,81,70,0,
2020-02-18,2,2,2,0,0,0,0,83,72,0,
2020-02-19,4,4,2,0,1,1,0,87,76,0,
2020-02-20,9,9,3,1,3,2,0,96,85,0,
2020-02-21,2,2,0,0,0,2,0,98,87,0,
2020-02-22,8,8,2,0,3,3,0,106,95,0,
2020-02-23,22,22,11,0,3,7,1,128,117,0,
2020-02-24,15,14,3,0,2,9,0,143,131,0,
2020-02-25,16,16,4,0,2,10,0,159,147,1,
2020-02-26,14,13,6,1,4,2,0,173,160,0,
2020-02-27,27,26,12,0,7,7,0,200,186,0,
2020-02-28,40,38,18,0,6,14,0,240,224,0,
2020-02-29,27,27,8,0,7,12,0,267,251,0,
2020-03-01,59,59,11,0,27,20,1,326,310,1,
2020-03-02,56,56,8,0,18,30,0,382,366,0,
2020-03-03,56,56,16,0,12,28,0,438,422,0,
2020-03-04,60,58,12,1,15,30,0,498,480,0,
2020-03-05,67,67,12,1,23,31,0,565,547,0,
2020-03-06,86,85,16,2,27,40,0,651,632,0,
2020-03-07,92,92,15,3,30,44,0,743,724,1,
2020-03-08,134,133,27,2,44,60,0,877,857,0,
2020-03-09,223,222,44,10,78,90,0,1100,1079,0,
2020-03-10,254,252,54,9,71,118,0,1354,1331,0,
2020-03-11,294,294,73,11,84,125,1,1648,1625,1,
2020-03-12,389,389,92,9,128,159,1,2037,2014,0,
2020-03-13,467,463,125,8,153,175,2,2504,2477,0,
2020-03-14,467,464,99,14,166,183,2,2971,2941,0,
2020-03-15,602,599,151,10,211,225,2,3573,3540,1,
2020-03-16,845,837,251,10,307,267,2,4418,4377,0,
2020-03-17,870,867,259,16,323,264,5,5288,5244,0,
2020-03-18,971,965,281,20,357,303,4,6259,6209,0,
2020-03-19,811,804,253,12,300,236,3,7070,7013,0,
2020-03-20,1058,1054,363,21,424,237,9,8128,8067,1,
2020-03-21,908,897,318,9,328,238,4,9036,8964,0,
2020-03-22,872,863,320,13,344,184,2,9908,9827,0,
2020-03-23,1096,1080,465,16,417,173,9,11004,10907,0,
2020-03-24,996,988,399,21,390,173,5,12000,11895,0,
2020-03-25,1005,994,449,13,417,108,7,13005,12889,0,
2020-03-26,939,930,449,12,343,117,9,13944,13819,0,
2020-03-27,969,959,481,9,372,84,13,14913,14778,0,
2020-03-28,977,968,473,9,391,84,11,15890,15746,0,
2020-03-29,885,877,461,7,353,50,6,16775,16623,1,
2020-03-30,1179,1172,582,10,490,77,13,17954,17795,0,
2020-03-31,1005,1000,557,3,359,68,13,18959,18795,0,
2020-04-01,1320,1309,754,12,450,83,10,20279,20104,0,
2020-04-02,1191,1186,746,11,375,46,8,21470,21290,0,
2020-04-03,1340,1329,886,6,375,53,9,22810,22619,0,
2020-04-04,1173,1170,744,9,369,29,19,23983,23789,0,
2020-04-05,1078,1074,679,5,369,13,8,25061,24863,0,
2020-04-06,1442,1439,886,11,515,14,13,26503,26302,0,
2020-04-07,1307,1303,791,13,470,16,13,27810,27605,0,
2020-04-08,1405,1401,882,10,489,6,14,29215,29006,0,
2020-04-09,1506,1503,967,14,495,4,23,30721,30509,0,
2020-04-10,1809,1808,1136,19,623,6,24,32530,32317,0,
2020-04-11,1714,1712,971,11,687,4,39,34244,34029,1,
2020-04-12,1445,1444,886,16,508,7,27,35689,35473,0,
2020-04-13,2129,2129,1169,33,890,6,31,37818,37602,0,
2020-04-14,1816,1815,1091,21,668,2,33,39634,39417,0,
2020-04-15,1961,1957,1230,22,676,4,25,41595,41374,0,
2020-04-16,1962,1959,1105,19,779,1,55,43557,43333,0,
2020-04-17,1859,1856,1102,17,700,3,34,45416,45189,0,
2020-04-18,1614,1611,1039,20,522,3,27,47030,46800,0,
2020-04-19,1230,1228,743,15,455,4,11,48260,48028,0,
2020-04-20,1843,1839,1080,10,713,2,34,50103,49867,0,
2020-04-21,1411,1411,841,13,522,6,29,51514,51278,0,
2020-04-22,1571,1569,910,13,615,1,30,53085,52847,0,
2020-04-23,1584,1579,917,18,607,5,32,54669,54426,0,
2020-04-24,1538,1535,929,11,550,2,43,56207,55961,0,
2020-04-25,1405,1400,823,14,477,5,81,57612,57361,0,
2020-04-26,1317,1315,790,13,466,4,42,58929,58676,0,
2020-04-27,1656,1650,951,12,642,5,40,60585,60326,0,
2020-04-28,1531,1522,929,18,547,6,22,62116,61848,0,
2020-04-29,1488,1486,807,4,658,2,15,63604,63334,0,
2020-04-30,1470,1465,827,4,614,3,17,65074,64799,0,
2020-05-01,1589,1587,890,8,666,4,19,66663,66386,0,
2020-05-02,1070,1068,657,8,383,0,20,67733,67454,0,
2020-05-03,1021,1020,620,6,379,5,10,68754,68474,1,
2020-05-04,1361,1360,774,6,557,2,21,70115,69834,0,
2020-05-05,1300,1298,728,6,537,1,26,71415,71132,0,
2020-05-06,1129,1128,661,8,439,2,18,72544,72260,0,
2020-05-07,1178,1173,711,4,434,6,18,73722,73433,0,
2020-05-08,1182,1179,698,7,458,1,15,74904,74612,0,
2020-05-09,1023,1020,633,8,357,4,18,75927,75632,0,
2020-05-10,920,918,542,7,353,5,11,76847,76550,0,
2020-05-11,1222,1222,726,8,450,7,31,78069,77772,0,
2020-05-12,1163,1161,716,2,417,6,20,79232,78933,0,
2020-05-13,1105,1102,650,3,430,3,16,80337,80035,0,
2020-05-14,1160,1160,685,3,453,5,14,81497,81195,0,
2020-05-15,1216,1216,711,0,481,11,13,82713,82411,0,
2020-05-16,996,995,601,2,377,2,13,83709,83406,0,
2020-05-17,913,912,537,2,352,8,13,84622,84318,0,
2020-05-18,1092,1086,618,2,454,5,7,85714,85404,0,
2020-05-19,962,961,583,3,363,4,8,86676,86365,0,
2020-05-20,1121,1119,650,2,455,1,11,87797,87484,0,
2020-05-21,885,884,547,2,318,6,11,88682,88368,0,
2020-05-22,841,839,513,0,319,5,2,89523,89207,0,
2020-05-23,691,690,441,1,238,4,6,90214,89897,0,
2020-05-24,651,649,400,0,234,4,11,90865,90546,0,
2020-05-25,857,857,507,3,326,4,17,91722,91403,0,
2020-05-26,747,747,458,1,275,7,6,92469,92150,0,
2020-05-27,714,710,425,2,271,2,10,93183,92860,0,
2020-05-28,595,594,361,2,218,2,11,93778,93454,0,
2020-05-29,731,730,445,0,277,3,5,94509,94184,0,
2020-05-30,565,562,397,2,160,1,2,95074,94746,0,
2020-05-31,408,407,258,0,139,4,6,95482,95153,0,
2020-06-01,687,686,395,6,256,6,23,96169,95839,0,
2020-06-02,493,489,320,1,159,5,4,96662,96328,0,
2020-06-03,492,491,321,4,153,4,9,97154,96819,0,
2020-06-04,461,460,265,1,177,11,6,97615,97279,0,
2020-06-05,446,442,312,0,124,3,3,98061,97721,0,
2020-06-06,371,369,234,1,127,4,3,98432,98090,0,
2020-06-07,314,310,214,1,89,1,5,98746,98400,0,
2020-06-08,432,428,289,6,118,10,5,99178,98828,0,
2020-06-09,374,372,244,3,116,4,5,99552,99200,0,
2020-06-10,441,438,258,5,156,10,9,99993,99638,0,
2020-06-11,376,369,242,3,116,5,3,100369,100007,0,
2020-06-12,375,371,224,5,133,6,3,100744,100378,0,
2020-06-13,277,275,181,1,86,5,2,101021,100653,0,
2020-06-14,300,296,186,0,98,9,3,101321,100949,0,
2020-06-15,403,399,246,4,138,7,4,101724,101348,0,
2020-06-16,367,363,234,2,112,10,5,102091,101711,0,
2020-06-17,360,358,228,0,120,6,4,102451,102069,0,
2020-06-18,328,326,198,1,119,4,4,102779,102395,0,
2020-06-19,335,335,231,0,89,11,4,103114,102730,0,
2020-06-20,283,282,186,0,87,8,1,103397,103012,0,
2020-06-21,270,268,175,0,87,4,2,103667,103280,0,
2020-06-22,323,320,211,2,99,4,4,103990,103600,0,
2020-06-23,327,326,219,2,92,6,7,104317,103926,0,
2020-06-24,285,285,183,2,87,9,4,104602,104211,0,
2020-06-25,463,461,326,2,122,5,6,105065,104672,0,
2020-06-26,276,273,170,0,86,11,6,105341,104945,0,
2020-06-27,251,250,165,1,74,7,3,105592,105195,0,
2020-06-28,239,236,136,1,89,9,1,105831,105431,0,
2020-06-29,332,329,198,2,108,10,11,106163,105760,0,
2020-06-30,309,302,197,4,96,2,3,106472,106062,0,
2020-07-01,287,276,177,8,85,5,1,106759,106338,0,
2020-07-02,268,260,161,1,85,6,7,107027,106598,0,
2020-07-03,305,295,184,2,93,13,3,107332,106893,0,
2020-07-04,292,283,173,3,96,10,1,107624,107176,0,
2020-07-05,271,271,177,3,84,6,1,107895,107447,0,
2020-07-06,503,495,268,2,180,17,28,108398,107942,0,
2020-07-07,519,510,263,6,212,19,10,108917,108452,0,
2020-07-08,439,427,279,4,129,10,5,109356,108879,0,
2020-07-09,449,433,268,3,141,12,9,109805,109312,0,
2020-07-10,412,396,258,5,114,14,5,110217,109708,0,
2020-07-11,384,380,228,3,135,12,2,110601,110088,0,
2020-07-12,397,388,236,3,141,6,2,110998,110476,0,
2020-07-13,607,586,359,12,199,12,4,111605,111062,0,
2020-07-14,546,517,299,4,193,13,8,112151,111579,0,
2020-07-15,566,541,311,3,197,16,14,112717,112120,0,
2020-07-16,458,436,258,4,154,17,3,113175,112556,0,
2020-07-17,503,484,272,6,188,7,11,113678,113040,0,
2020-07-18,409,390,228,2,146,7,7,114087,113430,0,
2020-07-19,391,379,202,4,160,12,1,114478,113809,0,
2020-07-20,526,497,264,6,208,14,5,115004,114306,0,
2020-07-21,522,510,266,10,223,6,5,115526,114816,0,
2020-07-22,446,433,181,6,232,10,4,115972,115249,0,
2020-07-23,445,423,173,3,235,7,5,116417,115672,0,
2020-07-24,457,442,180,7,243,5,7,116874,116114,0,
2020-07-25,308,304,109,4,182,6,3,117182,116418,0,
2020-07-26,332,325,102,6,205,10,2,117514,116743,0,
2020-07-27,471,457,176,3,260,14,4,117985,117200,0,
2020-07-28,416,404,154,1,230,14,5,118401,117604,0,
2020-07-29,403,396,138,1,250,3,4,118804,118000,0,
2020-07-30,330,316,109,1,190,6,10,119134,118316,0,
2020-07-31,339,330,120,0,194,10,6,119473,118646,0,
2020-08-01,340,331,114,8,185,17,7,119813,118977,0,
2020-08-02,331,322,123,6,185,6,2,120144,119299,0,
2020-08-03,427,423,160,2,250,10,1,120571,119722,0,
2020-08-04,447,432,186,0,219,20,7,121018,120154,0,
2020-08-05,380,374,170,9,184,8,3,121398,120528,0,
2020-08-06,344,333,161,4,156,7,5,121742,120861,0,
2020-08-07,385,381,189,2,173,6,11,122127,121242,0,
2020-08-08,333,330,151,4,169,2,4,122460,121572,0,
2020-08-09,322,314,150,7,147,7,3,122782,121886,0,
2020-08-10,472,468,215,8,230,12,3,123254,122354,0,
2020-08-11,472,440,217,5,207,10,1,123726,122794,0,
2020-08-12,406,395,211,11,158,12,3,124132,123189,0,
2020-08-13,421,412,222,8,170,10,2,124553,123601,0,
2020-08-14,375,373,175,7,179,9,3,124928,123974,0,
2020-08-15,366,363,171,7,172,7,6,125294,124337,0,
2020-08-16,379,373,167,14,185,4,3,125673,124710,0,
2020-08-17,543,539,262,11,251,7,8,126216,125249,0,
2020-08-18,424,419,205,4,194,4,12,126640,125668,0,
2020-08-19,445,437,207,9,206,5,10,127085,126105,0,
2020-08-20,440,438,222,5,194,4,13,127525,126543,0,
2020-08-21,421,417,206,9,189,5,8,127946,126960,0,
2020-08-22,394,393,225,7,153,5,3,128340,127353,0,
2020-08-23,404,401,204,3,187,6,1,128744,127754,0,
2020-08-24,572,569,266,15,272,7,9,129316,128323,0,
2020-08-25,613,604,293,12,288,10,1,129929,128927,0,
2020-08-26,612,604,286,13,295,5,5,130541,129531,0,
2020-08-27,481,477,230,11,223,3,10,131022,130008,0,
2020-08-28,556,551,262,11,264,6,8,131578,130559,0,
2020-08-29,456,454,206,10,215,5,18,132034,131013,0,
2020-08-30,556,548,243,4,277,7,17,132590,131561,0,
2020-08-31,646,639,260,11,342,9,17,133236,132200,0,
2020-09-01,744,740,301,18,390,7,24,133980,132940,0,
2020-09-02,776,766,333,12,389,8,24,134756,133706,0,
2020-09-03,657,652,267,5,361,4,15,135413,134358,0,
2020-09-04,719,714,287,9,396,10,12,136132,135072,0,
2020-09-05,667,662,254,9,374,9,16,136799,135734,0,
2020-09-06,685,675,269,4,390,8,4,137484,136409,0,
2020-09-07,787,778,299,9,449,9,12,138271,137187,1,
2020-09-08,958,950,353,13,557,10,17,139229,138137,0,
2020-09-09,1007,998,376,12,587,4,19,140236,139135,0,
2020-09-10,998,986,377,6,564,9,30,141234,140121,0,
2020-09-11,972,959,356,10,569,9,15,142206,141080,0,
2020-09-12,973,965,388,8,549,3,17,143179,142045,0,
2020-09-13,967,962,344,8,592,6,12,144146,143007,0,
2020-09-14,1258,1250,478,14,724,7,27,145404,144257,0,
2020-09-15,1312,1294,448,10,796,3,37,146716,145551,0,
2020-09-16,1357,1341,494,22,795,4,26,148073,146892,0,
2020-09-17,1327,1310,480,21,777,6,26,149400,148202,0,
2020-09-18,1425,1414,521,8,851,1,33,150825,149616,0,
2020-09-19,1234,1216,393,18,781,6,18,152059,150832,0,
2020-09-20,1356,1342,418,12,867,9,36,153415,152174,0,
2020-09-21,1815,1795,561,16,1159,6,53,155230,153969,0,
2020-09-22,1859,1836,523,13,1245,7,48,157089,155805,0,
2020-09-23,1907,1894,558,15,1230,2,89,158996,157699,0,
2020-09-24,1956,1936,526,10,1305,2,93,160952,159635,0,
2020-09-25,2047,2029,562,20,1344,9,94,162999,161664,0,
2020-09-26,1879,1866,504,7,1253,4,98,164878,163530,0,
2020-09-27,1966,1948,477,10,1333,6,122,166844,165478,0,
2020-09-28,2476,2447,626,16,1668,3,134,169320,167925,0,
2020-09-29,2266,2251,553,23,1529,3,143,171586,170176,0,
2020-09-30,2254,2236,564,16,1546,1,109,173840,172412,0,
2020-10-01,2164,2154,585,9,1458,9,93,176004,174566,0,
2020-10-02,2131,2101,548,17,1423,9,104,178135,176667,0,
2020-10-03,1824,1794,474,19,1201,10,90,179959,178461,0,
2020-10-04,1842,1816,509,14,1210,4,79,181801,180277,0,
2020-10-05,2440,2400,676,20,1591,4,109,184241,182677,0,
2020-10-06,2322,2270,678,31,1429,10,122,186563,184947,0,
2020-10-07,2274,2238,689,20,1413,9,107,188837,187185,0,
2020-10-08,2233,2200,654,14,1417,10,105,191070,189385,0,
2020-10-09,2300,2254,654,18,1464,7,111,193370,191639,0,
2020-10-10,2170,2139,683,17,1352,7,80,195540,193778,0,
2020-10-11,1909,1870,602,17,1153,5,93,197449,195648,0,
2020-10-12,2335,2288,715,19,1452,8,94,199784,197936,0,
2020-10-13,2573,2514,862,22,1513,9,108,202357,200450,0,
2020-10-14,2512,2465,878,27,1453,7,100,204869,202915,0,
2020-10-15,2566,2515,840,24,1542,9,100,207435,205430,0,
2020-10-16,2659,2603,893,19,1583,4,104,210094,208033,0,
2020-10-17,2303,2256,819,25,1300,6,106,212397,210289,0,
2020-10-18,2232,2171,803,13,1251,12,92,214629,212460,0,
2020-10-19,2958,2870,1124,22,1597,7,120,217587,215330,0,
2020-10-20,2818,2749,1103,27,1460,9,150,220405,218079,0,
2020-10-21,2790,2701,1007,33,1503,9,149,223195,220780,0,
2020-10-22,2800,2687,1094,21,1445,2,125,225995,223467,0,
2020-10-23,2825,2712,1047,31,1494,7,133,228820,226179,0,
2020-10-24,2636,2548,1034,34,1319,10,151,231456,228727,0,
2020-10-25,2640,2518,1023,32,1341,7,115,234096,231245,0,
2020-10-26,3392,3259,1270,23,1762,10,194,237488,234504,0,
2020-10-27,3352,3191,1350,36,1634,9,162,240840,237695,0,
2020-10-28,3619,3485,1430,38,1810,9,198,244459,241180,0,
2020-10-29,3097,2951,1254,33,1535,7,122,247556,244131,0,
2020-10-30,3522,3369,1328,44,1832,10,155,251078,247500,0,
2020-10-31,3155,3023,1354,32,1489,8,140,254233,250523,0,
2020-11-01,3439,3289,1381,33,1719,8,148,257672,253812,0,
2020-11-02,4565,4321,1846,43,2229,7,196,262237,258133,0,
2020-11-03,4492,4272,1798,34,2147,15,278,266729,262405,0,
2020-11-04,4617,4374,1912,48,2210,7,197,271346,266779,0,
2020-11-05,4540,4292,1740,34,2229,8,281,275886,271071,0,
2020-11-06,4616,4323,1805,22,2239,10,247,280502,275394,0,
2020-11-07,4306,3883,1528,17,2120,9,209,284808,279277,0,
2020-11-08,4028,3562,1448,13,1917,8,176,288836,282839,0,
2020-11-09,5281,4597,1814,26,2497,14,246,294117,287436,0,
2020-11-10,5135,4381,1734,19,2378,14,236,299252,291817,0,
2020-11-11,4943,4366,1812,26,2305,9,214,304195,296183,0,
2020-11-12,5035,4510,1703,19,2548,11,229,309230,300693,0,
2020-11-13,5183,4864,1781,17,2829,16,221,314413,305557,0,
2020-11-14,4522,4259,1685,11,2374,13,176,318935,309816,0,
2020-11-15,4454,4097,1633,22,2277,18,147,323389,313913,0,
2020-11-16,5589,5188,2026,17,2955,21,169,328978,319101,0,
2020-11-17,5414,5024,1908,18,2862,13,223,334392,324125,0,
2020-11-18,5643,5240,2101,28,2910,12,189,340035,329365,0,
2020-11-19,5500,5095,1862,24,2983,16,210,345535,334460,0,
2020-11-20,5511,5102,1973,30,2876,15,208,351046,339562,0,
2020-11-21,5068,4673,1820,23,2646,15,169,356114,344235,0,
2020-11-22,4857,4325,1759,26,2341,22,177,360971,348560,0,
2020-11-23,6325,5709,2255,35,3163,16,240,367296,354269,0,
2020-11-24,6229,5666,2189,31,3174,10,262,373525,359935,0,
2020-11-25,6387,6053,2183,28,3512,15,315,379912,365988,0,
2020-11-26,6104,5838,2143,30,3448,17,200,386016,371826,0,
2020-11-27,6236,5961,2081,34,3611,18,217,392252,377787,0,
2020-11-28,5587,5343,1986,23,3041,15,278,397839,383130,0,
2020-11-29,5414,5157,1714,31,3161,15,236,403253,388287,0,
2020-11-30,6911,6619,2300,37,3988,21,273,410164,394906,0,
2020-12-01,6772,6485,2334,21,3866,7,257,416936,401391,0,
2020-12-02,6699,6424,2144,37,3973,13,257,423635,407815,0,
2020-12-03,6705,6383,2187,34,3854,17,291,430340,414198,0,
2020-12-04,6791,6442,2195,41,3928,10,268,437131,420640,0,
2020-12-05,5819,5563,1843,39,3420,12,249,442950,426203,0,
2020-12-06,5795,5529,1921,34,3285,31,258,448745,431732,0,
2020-12-07,7655,7271,2512,48,4336,26,349,456400,439003,0,
2020-12-08,7174,6889,2282,40,4194,16,357,463574,445892,0,
2020-12-09,6902,6595,2222,30,3950,19,374,470476,452487,0,
2020-12-10,6838,6540,2106,46,4021,24,343,477314,459027,0,
2020-12-11,6830,6569,2124,50,4020,22,353,484144,465596,0,
2020-12-12,6158,5915,1863,43,3669,24,316,490302,471511,0,
2020-12-13,5520,5299,1744,26,3233,16,280,495822,476810,0,
2020-12-14,7673,7352,2317,41,4502,29,463,503495,484162,0,
2020-12-15,7209,6928,2132,33,4316,17,430,510704,491090,0,
2020-12-16,6875,6629,2097,47,4050,9,426,517579,497719,,
2020-12-17,6640,6388,1898,36,4018,26,410,524219,504107,,
2020-12-18,6907,6692,2016,53,4170,20,433,531126,510799,,
2020-12-19,5888,5744,1767,41,3617,17,302,537014,516543,,
2020-12-20,5874,5725,1819,32,3550,20,304,542888,522268,,
2020-12-21,7573,7309,2213,41,4568,16,471,550461,529577,,
2020-12-22,7113,6894,2159,44,4252,22,417,557574,536471,,
2020-12-23,7380,7168,2264,49,4383,30,442,564954,543639,,
2020-12-24,6877,6753,2129,43,4165,14,402,571831,550392,,
2020-12-25,5693,5587,1817,52,3430,15,273,577524,555979,,
2020-12-26,7599,7410,2564,56,4420,24,346,585123,563389,,
2020-12-27,7537,7383,2680,68,4243,19,373,592660,570772,,
2020-12-28,8938,8695,3018,52,5147,25,453,601598,579467,,
2020-12-29,8139,7886,2817,72,4534,16,447,609737,587353,,
2020-12-30,7836,7575,2651,59,4357,39,469,617573,594928,,
2020-12-31,7417,7185,2610,57,4076,15,427,624990,602113,,
2021-01-01,6785,6616,2379,40,3806,27,364,631775,608729,,
2021-01-02,7500,7296,2761,69,3990,43,433,639275,616025,,
2021-01-03,7283,7063,2554,61,4018,48,382,646558,623088,,
2021-01-04,8906,8587,3095,69,4837,32,554,655464,631675,,
2021-01-05,7773,7493,2807,64,4096,48,478,663237,639168,,
2021-01-06,7701,7398,2650,59,4084,53,552,670938,646566,,
2021-01-07,6874,6621,2361,54,3684,37,485,677812,653187,,
2021-01-08,6744,6497,2351,57,3560,39,490,684556,659684,,
2021-01-09,5970,5796,2066,54,3232,40,404,690526,665480,,
2021-01-10,5568,5401,1948,58,2991,29,375,696094,670881,,
2021-01-11,6877,6541,2485,59,3464,36,497,702971,677422,,
2021-01-12,6073,5800,2168,71,3087,30,444,709044,683222,,
2021-01-13,6075,5848,2112,49,3180,32,475,715119,689070,,
2021-01-14,5633,5397,2068,43,2818,28,440,720752,694467,,
2021-01-15,5996,5698,2066,40,3167,30,395,726748,700165,,
2021-01-16,4692,4531,1686,37,2504,20,284,731440,704696,,
2021-01-17,4466,4325,1583,38,2343,36,325,735906,709021,,
2021-01-18,5639,5380,1992,40,2842,29,477,741545,714401,,
2021-01-19,5190,4965,1823,48,2630,12,452,746735,719366,,
2021-01-20,5034,4785,1829,56,2510,23,367,751769,724151,,
2021-01-21,4761,4565,1680,30,2440,26,389,756530,728716,,
2021-01-22,4498,4297,1656,38,2281,18,304,761028,733013,,
2021-01-23,3933,3793,1433,43,2019,15,283,764961,736806,,
2021-01-24,3483,3342,1249,28,1815,11,239,768444,740148,,
2021-01-25,4618,4398,1604,37,2346,17,394,773062,744546,,
2021-01-26,4078,3885,1413,40,2085,8,339,777140,748431,,
2021-01-27,4142,3939,1509,28,2074,15,313,781282,752370,,
2021-01-28,3839,3639,1324,31,2008,16,260,785121,756009,,
2021-01-29,3741,3553,1290,40,1980,14,229,788862,759562,,
2021-01-30,3134,3000,1067,23,1676,10,224,791996,762562,,
2021-01-31,2851,2713,1046,24,1453,18,172,794847,765275,,
2021-02-01,4090,3803,1351,21,2040,16,375,798937,769078,,
2021-02-02,3614,3332,1266,33,1770,10,253,802551,772410,,
2021-02-03,3539,3206,1215,22,1726,10,233,806090,775616,,
2021-02-04,3345,2980,1155,26,1543,13,243,809435,778596,,
2021-02-05,3359,2787,1138,26,1366,16,241,812794,781383,,
2021-02-06,2787,2148,1031,18,961,7,131,815581,783531,,
2021-02-07,2628,1771,956,24,643,11,137,818209,785302,,
2021-02-08,3492,2267,1264,19,754,9,221,821701,787569,,
2021-02-09,3228,2024,1104,29,702,13,176,824929,789593,,
2021-02-10,3291,2169,1247,30,752,5,135,828220,791762,,
2021-02-11,2880,1922,1147,24,608,7,136,831100,793684,,
2021-02-12,3100,2047,1161,21,688,7,170,834200,795731,,
2021-02-13,2671,1871,1097,17,599,4,154,836871,797602,,
2021-02-14,2529,1694,997,16,569,20,92,839400,799296,,
2021-02-15,3033,1998,1174,33,661,6,124,842433,801294,,
2021-02-16,3005,2084,1238,26,643,13,164,845438,803378,,
2021-02-17,3080,2118,1262,28,643,8,177,848518,805496,,
2021-02-18,3014,2108,1259,31,616,7,195,851532,807604,,
2021-02-19,2991,2083,1216,24,672,6,165,854523,809687,,
2021-02-20,2737,1875,1115,26,602,10,122,857260,811562,,
2021-02-21,2527,1789,1022,14,621,10,122,859787,813351,,
2021-02-22,3204,2213,1298,15,702,6,192,862991,815564,,
2021-02-23,3008,2128,1280,11,682,4,151,865999,817692,,
2021-02-24,3106,2152,1304,18,656,7,167,869105,819844,,
2021-02-25,2829,2001,1213,15,627,4,142,871934,821845,,
2021-02-26,2927,2082,1277,19,621,10,155,874861,823927,,
2021-02-27,2704,1997,1206,11,615,13,152,877565,825924,,
2021-02-28,2644,1955,1180,21,604,9,141,880209,827879,,
2021-03-01,3505,2529,1467,19,820,6,217,883714,830408,,
2021-03-02,3116,2277,1385,22,693,6,171,886830,832685,,
2021-03-03,3285,2371,1459,19,728,14,151,890115,835056,,
2021-03-04,2861,2150,1286,22,682,15,145,892976,837206,,
2021-03-05,3218,2391,1492,21,708,3,167,896194,839597,,
2021-03-06,2803,2100,1276,5,657,9,153,898997,841697,,
2021-03-07,2698,2011,1182,13,680,9,127,901695,843708,,
2021-03-08,3541,2664,1606,12,829,19,198,905236,846372,,
2021-03-09,3370,2574,1556,24,776,10,208,908606,848946,,
2021-03-10,3664,2788,1703,23,822,12,228,912270,851734,,
2021-03-11,3290,2470,1490,15,752,17,196,915560,854204,,
2021-03-12,3395,2603,1555,10,793,15,230,918955,856807,,
2021-03-13,3165,2431,1514,10,743,10,154,922120,859238,,
2021-03-14,3066,2291,1365,11,744,22,149,925186,861529,,
2021-03-15,4153,3302,1984,12,1064,16,226,929339,864831,,
2021-03-16,4005,3111,1906,11,961,13,220,933344,867942,,
2021-03-17,4399,3517,2212,9,1062,18,216,937743,871459,,
2021-03-18,4005,3176,2026,12,926,15,197,941748,874635,,
2021-03-19,4333,3404,2059,12,1089,11,233,946081,878039,,
2021-03-20,4175,3303,1982,12,1100,8,201,950256,881342,,
2021-03-21,4197,3313,1946,16,1103,26,222,954453,884655,,
2021-03-22,5310,4136,2422,20,1399,13,282,959763,888791,,
2021-03-23,5547,4322,2456,24,1509,24,309,965310,893113,,
2021-03-24,5596,4459,2664,20,1442,18,315,970906,897572,,
2021-03-25,5228,4071,2372,17,1362,16,304,976134,901643,,
2021-03-26,5663,4465,2602,22,1472,19,350,981797,906108,,
2021-03-27,5359,4212,2455,22,1455,9,271,987156,910320,,
2021-03-28,5415,4229,2463,17,1448,20,281,992571,914549,,
2021-03-29,6664,5283,3074,15,1818,21,355,999235,919832,,
2021-03-30,6722,5280,3091,21,1786,26,356,1005957,925112,,
2021-03-31,6781,5398,3152,30,1854,18,344,1012738,930510,,
2021-04-01,7831,6335,3518,37,2200,18,562,1020569,936845,,
2021-04-02,7151,5682,3284,35,1906,13,444,1027720,942527,,
2021-04-03,7144,5648,3285,32,1794,16,521,1034864,948175,,
2021-04-04,7393,5853,3342,29,1989,21,472,1042257,954028,,
2021-04-05,9577,7703,4341,39,2617,34,672,1051834,961731,,
2021-04-06,9587,7741,4415,50,2545,24,707,1061421,969472,,
2021-04-07,9607,7768,4418,43,2568,27,712,1071028,977240,,
2021-04-08,8981,7262,4074,38,2372,22,756,1080009,984502,,
2021-04-09,9015,7248,3959,41,2459,41,748,1089024,991750,,
2021-04-10,8542,7007,3838,41,2394,32,702,1097566,998757,,
2021-04-11,7792,6289,3410,32,2197,29,621,1105358,1005046,,
2021-04-12,9280,7502,4224,40,2408,35,795,1114638,1012548,,
2021-04-13,8655,7066,3955,32,2305,29,745,1123293,1019614,,
2021-04-14,8795,7222,4013,38,2290,31,850,1132088,1026836,,
2021-04-15,8084,6707,3775,29,2098,21,784,1140172,1033543,,
2021-04-16,8275,6915,3846,22,2336,27,684,1148447,1040458,,
2021-04-17,7873,6575,3715,36,2108,25,691,1156320,1047033,,
2021-04-18,7183,6054,3375,26,1993,35,625,1163503,1053087,,
2021-04-19,8752,7349,4105,36,2383,43,782,1172255,1060436,,
2021-04-20,8273,6975,4043,27,2209,30,666,1180528,1067411,,
2021-04-21,8181,6959,3997,27,2226,56,653,1188709,1074370,,
2021-04-22,7630,6477,3712,18,2104,55,588,1196339,1080847,,
2021-04-23,8059,6909,3930,33,2206,48,692,1204398,1087756,,
2021-04-24,7280,6144,3560,22,1978,21,563,1211678,1093900,,
2021-04-25,6755,5688,3329,21,1841,31,466,1218433,1099588,,
2021-04-26,8182,6941,4018,27,2204,43,649,1226615,1106529,,
2021-04-27,7634,6474,3825,21,1983,19,626,1234249,1113003,,
2021-04-28,8116,6877,3991,27,2151,20,688,1242365,1119880,,
2021-04-29,7118,6022,3554,24,1808,11,625,1249483,1125902,,
2021-04-30,7371,6278,3612,21,1935,35,675,1256854,1132180,,
2021-05-01,7008,6056,3534,17,1985,12,508,1263862,1138236,,
2021-05-02,6113,5247,3168,25,1610,12,432,1269975,1143483,,
2021-05-03,7521,6387,3810,25,2051,19,482,1277496,1149870,,
2021-05-04,6872,5788,3560,22,1790,26,390,1284368,1155658,,
2021-05-05,6738,5756,3502,26,1815,19,394,1291106,1161414,,
2021-05-06,6152,5153,3154,11,1600,14,374,1297258,1166567,,
2021-05-07,6275,5258,3200,18,1675,21,344,1303533,1171825,,
2021-05-08,5597,4726,2884,25,1519,10,288,1309130,1176551,,
2021-05-09,5011,4230,2639,20,1352,5,214,1314141,1180781,,
2021-05-10,6280,5219,3122,24,1693,18,362,1320421,1186000,,
2021-05-11,5478,4549,2740,26,1452,6,325,1325899,1190549,,
2021-05-12,5440,4535,2781,18,1466,6,264,1331339,1195084,,
2021-05-13,4951,4098,2534,17,1301,12,234,1336290,1199182,,
2021-05-14,4888,4050,2402,10,1348,10,280,1341178,1203232,,
2021-05-15,4284,3543,2136,9,1160,9,229,1345462,1206775,,
2021-05-16,3786,3117,1849,5,1083,9,171,1349248,1209892,,
2021-05-17,4525,3690,2195,9,1176,13,297,1353773,1213582,,
2021-05-18,4078,3281,1930,11,1069,6,265,1357851,1216863,,
2021-05-19,3702,2993,1813,14,969,2,195,1361553,1219856,,
2021-05-20,3479,2816,1673,9,887,6,241,1365032,1222672,,
2021-05-21,3259,2631,1566,7,831,7,220,1368291,1225303,,
2021-05-22,2632,2168,1302,8,712,4,142,1370923,1227471,,
2021-05-23,2301,1847,1092,1,637,3,114,1373224,1229318,,
2021-05-24,2412,1947,1157,6,662,2,120,1375636,1231265,,
2021-05-25,2685,2146,1340,1,662,5,138,1378321,1233411,,
2021-05-26,2403,1919,1203,7,602,4,103,1380724,1235330,,
2021-05-27,2217,1787,1145,6,540,5,91,1382941,1237117,,
2021-05-28,2084,1665,1065,3,505,3,89,1385025,1238782,,
2021-05-29,1671,1336,816,1,441,7,71,1386696,1240118,,
2021-05-30,1515,1225,771,6,389,7,52,1388211,1241343,,
2021-05-31,1968,1570,1021,1,467,6,75,1390179,1242913,,
2021-06-01,1834,1483,916,7,469,7,84,1392013,1244396,,
2021-06-02,1733,1366,880,3,421,2,60,1393746,1245762,,
2021-06-03,1497,1209,765,5,375,4,60,1395243,1246971,,
2021-06-04,1475,1143,712,3,360,5,63,1396718,1248114,,
2021-06-05,1225,992,622,3,318,5,44,1397943,1249106,,
2021-06-06,1089,859,550,0,270,2,37,1399032,1249965,,
2021-06-07,1438,1127,730,3,334,5,55,1400470,1251092,,
2021-06-08,1199,937,574,2,301,8,52,1401669,1252029,,
2021-06-09,1189,940,618,6,242,6,68,1402858,1252969,,
2021-06-10,1168,888,606,5,219,8,50,1404026,1253857,,
2021-06-11,1048,806,506,1,239,10,50,1405074,1254663,,
2021-06-12,895,697,438,4,188,8,59,1405969,1255360,,
2021-06-13,757,597,367,2,181,2,45,1406726,1255957,,
2021-06-14,1031,766,488,3,230,13,32,1407757,1256723,,
2021-06-15,880,665,440,0,194,6,25,1408637,1257388,,
2021-06-16,825,612,397,1,165,11,38,1409462,1258000,,
2021-06-17,684,500,329,2,140,6,23,1410146,1258500,,
2021-06-18,688,530,336,2,148,11,33,1410834,1259030,,
2021-06-19,520,410,226,0,144,4,36,1411354,1259440,,
2021-06-20,487,366,217,2,113,4,30,1411841,1259806,,
2021-06-21,608,474,271,1,156,4,42,1412449,1260280,,
2021-06-22,571,419,246,0,127,4,42,1413020,1260699,,
2021-06-23,536,391,227,1,109,5,49,1413556,1261090,,
2021-06-24,459,341,193,0,102,7,39,1414015,1261431,,
2021-06-25,354,265,151,1,64,0,49,1414369,1261696,,
2021-06-26,225,150,79,0,30,1,40,1414594,1261846,,
2021-06-27,166,96,41,0,20,1,34,1414760,1261942,,
2021-06-28,147,98,19,0,6,1,72,1414907,1262040,,
2021-06-29,22,6,0,0,1,0,5,1414929,1262046,,