date,new,NTotal_ExposureOnly,domestic-contactWithCase,domestic-contactWithTraveller,domestic-unknown,internationalTravel,infopending,cumulative,cumulativeNTotal_ExposureOnly,doubleFlagTest,shaded
2020-01-15,2,1,0,0,0,1,0,2,1,1,14
2020-01-16,5,5,1,0,4,0,0,7,6,1,
2020-01-17,1,1,0,0,0,1,0,8,7,0,
2020-01-18,0,0,0,0,0,0,0,8,7,0,
2020-01-19,0,0,0,0,0,0,0,8,7,0,
2020-01-20,1,0,0,0,0,0,0,9,7,0,
2020-01-21,4,3,0,0,3,0,0,13,10,0,
2020-01-22,5,5,1,0,2,2,0,18,15,1,
2020-01-23,0,0,0,0,0,0,0,18,15,0,
2020-01-24,3,3,0,0,1,2,0,21,18,0,
2020-01-25,4,4,2,0,2,0,0,25,22,0,
2020-01-26,2,2,1,0,1,0,0,27,24,0,
2020-01-27,7,6,2,0,4,0,0,34,30,0,
2020-01-28,5,4,0,0,3,1,0,39,34,1,
2020-01-29,2,2,0,0,1,0,1,41,36,0,
2020-01-30,2,1,1,0,0,0,0,43,37,0,
2020-01-31,2,1,0,0,1,0,0,45,38,0,
2020-02-01,5,5,3,0,1,1,0,50,43,0,
2020-02-02,3,3,0,0,2,1,0,53,46,0,
2020-02-03,1,1,0,0,1,0,0,54,47,0,
2020-02-04,2,2,0,0,2,0,0,56,49,0,
2020-02-05,3,3,1,0,1,1,0,59,52,0,
2020-02-06,0,0,0,0,0,0,0,59,52,0,
2020-02-07,0,0,0,0,0,0,0,59,52,0,
2020-02-08,1,0,0,0,0,0,0,60,52,0,
2020-02-09,1,1,0,0,0,1,0,61,53,0,
2020-02-10,2,2,0,0,1,1,0,63,55,0,
2020-02-11,2,2,0,0,2,0,0,65,57,0,
2020-02-12,4,3,2,0,1,0,0,69,60,0,
2020-02-13,1,1,0,0,0,1,0,70,61,0,
2020-02-14,7,6,0,0,3,2,1,77,67,0,
2020-02-15,3,2,1,0,0,1,0,80,69,1,
2020-02-16,1,1,0,0,0,1,0,81,70,0,
2020-02-17,2,2,1,0,0,1,0,83,72,0,
2020-02-18,2,2,2,0,0,0,0,85,74,0,
2020-02-19,4,4,2,0,1,1,0,89,78,0,
2020-02-20,9,9,3,1,3,2,0,98,87,0,
2020-02-21,3,3,0,0,1,2,0,101,90,0,
2020-02-22,8,8,2,0,3,3,0,109,98,0,
2020-02-23,22,22,11,0,3,7,1,131,120,0,
2020-02-24,15,14,3,0,2,9,0,146,134,0,
2020-02-25,16,16,4,0,2,10,0,162,150,1,
2020-02-26,14,13,6,1,4,2,0,176,163,0,
2020-02-27,27,26,12,0,7,7,0,203,189,0,
2020-02-28,39,37,17,0,6,14,0,242,226,0,
2020-02-29,27,27,8,0,7,12,0,269,253,0,
2020-03-01,60,60,12,0,27,20,1,329,313,1,
2020-03-02,56,56,8,0,18,30,0,385,369,0,
2020-03-03,55,55,15,0,12,28,0,440,424,0,
2020-03-04,61,59,13,1,15,30,0,501,483,0,
2020-03-05,67,67,12,1,23,31,0,568,550,0,
2020-03-06,86,85,17,2,26,40,0,654,635,0,
2020-03-07,92,92,15,3,30,44,0,746,727,1,
2020-03-08,134,133,27,2,44,60,0,880,860,0,
2020-03-09,224,223,44,10,79,90,0,1104,1083,0,
2020-03-10,256,254,55,9,72,118,0,1360,1337,0,
2020-03-11,295,295,74,11,84,125,1,1655,1632,1,
2020-03-12,389,389,92,9,128,159,1,2044,2021,0,
2020-03-13,467,463,125,8,153,175,2,2511,2484,0,
2020-03-14,469,466,99,14,168,183,2,2980,2950,0,
2020-03-15,603,600,152,10,211,225,2,3583,3550,1,
2020-03-16,848,840,254,10,307,267,2,4431,4390,0,
2020-03-17,871,868,260,16,323,264,5,5302,5258,0,
2020-03-18,972,966,282,20,358,302,4,6274,6224,0,
2020-03-19,812,805,254,12,300,236,3,7086,7029,0,
2020-03-20,1059,1055,363,21,424,238,9,8145,8084,1,
2020-03-21,909,898,320,8,328,238,4,9054,8982,0,
2020-03-22,872,863,320,13,343,185,2,9926,9845,0,
2020-03-23,1097,1081,465,16,418,173,9,11023,10926,0,
2020-03-24,996,988,399,21,390,173,5,12019,11914,0,
2020-03-25,1006,995,449,13,418,108,7,13025,12909,0,
2020-03-26,939,930,449,12,343,117,9,13964,13839,0,
2020-03-27,971,961,481,9,374,84,13,14935,14800,0,
2020-03-28,977,968,473,9,391,84,11,15912,15768,0,
2020-03-29,887,879,461,7,355,50,6,16799,16647,1,
2020-03-30,1181,1174,584,10,490,77,13,17980,17821,0,
2020-03-31,1008,1003,559,3,359,68,14,18988,18824,0,
2020-04-01,1323,1312,756,12,450,83,11,20311,20136,0,
2020-04-02,1194,1189,749,11,375,46,8,21505,21325,0,
2020-04-03,1341,1330,887,6,375,53,9,22846,22655,0,
2020-04-04,1173,1170,744,9,369,29,19,24019,23825,0,
2020-04-05,1079,1075,679,5,370,13,8,25098,24900,0,
2020-04-06,1442,1439,886,11,515,14,13,26540,26339,0,
2020-04-07,1308,1304,792,13,470,16,13,27848,27643,0,
2020-04-08,1406,1402,883,10,489,6,14,29254,29045,0,
2020-04-09,1508,1505,968,14,495,4,24,30762,30550,0,
2020-04-10,1811,1810,1137,19,624,6,24,32573,32360,0,
2020-04-11,1717,1715,974,11,687,4,39,34290,34075,1,
2020-04-12,1447,1446,888,16,508,7,27,35737,35521,0,
2020-04-13,2129,2129,1169,33,890,6,31,37866,37650,0,
2020-04-14,1821,1820,1096,21,668,2,33,39687,39470,0,
2020-04-15,1962,1958,1232,22,675,4,25,41649,41428,0,
2020-04-16,1962,1959,1105,19,779,1,55,43611,43387,0,
2020-04-17,1861,1858,1104,17,700,3,34,45472,45245,0,
2020-04-18,1619,1616,1042,20,524,3,27,47091,46861,0,
2020-04-19,1232,1230,744,15,456,4,11,48323,48091,0,
2020-04-20,1845,1841,1080,10,714,2,35,50168,49932,0,
2020-04-21,1412,1412,842,13,522,6,29,51580,51344,0,
2020-04-22,1571,1569,910,13,615,1,30,53151,52913,0,
2020-04-23,1583,1578,917,18,606,5,32,54734,54491,0,
2020-04-24,1538,1535,929,11,550,2,43,56272,56026,0,
2020-04-25,1406,1401,823,14,477,5,82,57678,57427,0,
2020-04-26,1317,1315,790,13,466,4,42,58995,58742,0,
2020-04-27,1657,1651,952,12,642,5,40,60652,60393,0,
2020-04-28,1532,1523,929,18,547,6,23,62184,61916,0,
2020-04-29,1488,1486,807,4,658,2,15,63672,63402,0,
2020-04-30,1471,1466,828,4,614,3,17,65143,64868,0,
2020-05-01,1593,1591,894,8,666,4,19,66736,66459,0,
2020-05-02,1071,1069,658,8,383,0,20,67807,67528,0,
2020-05-03,1022,1021,621,6,379,5,10,68829,68549,1,
2020-05-04,1362,1361,774,6,558,2,21,70191,69910,0,
2020-05-05,1300,1298,728,6,537,1,26,71491,71208,0,
2020-05-06,1128,1127,661,8,438,2,18,72619,72335,0,
2020-05-07,1178,1173,712,4,433,6,18,73797,73508,0,
2020-05-08,1185,1182,701,7,458,1,15,74982,74690,0,
2020-05-09,1024,1021,635,8,356,4,18,76006,75711,0,
2020-05-10,921,919,542,7,353,5,12,76927,76630,0,
2020-05-11,1223,1223,727,8,450,7,31,78150,77853,0,
2020-05-12,1166,1164,719,2,417,6,20,79316,79017,0,
2020-05-13,1105,1102,650,3,430,3,16,80421,80119,0,
2020-05-14,1160,1160,685,3,453,5,14,81581,81279,0,
2020-05-15,1216,1216,711,0,481,11,13,82797,82495,0,
2020-05-16,996,995,601,2,377,2,13,83793,83490,0,
2020-05-17,913,912,537,2,352,8,13,84706,84402,0,
2020-05-18,1091,1085,617,2,454,5,7,85797,85487,0,
2020-05-19,962,961,583,3,363,4,8,86759,86448,0,
2020-05-20,1122,1119,650,2,455,1,11,87881,87567,0,
2020-05-21,885,884,547,2,318,6,11,88766,88451,0,
2020-05-22,841,839,513,0,319,5,2,89607,89290,0,
2020-05-23,691,690,441,1,238,4,6,90298,89980,0,
2020-05-24,651,649,400,0,234,4,11,90949,90629,0,
2020-05-25,857,857,507,3,326,4,17,91806,91486,0,
2020-05-26,747,747,458,1,275,7,6,92553,92233,0,
2020-05-27,714,710,425,2,271,2,10,93267,92943,0,
2020-05-28,595,594,361,2,218,2,11,93862,93537,0,
2020-05-29,730,729,444,0,277,3,5,94592,94266,0,
2020-05-30,565,562,397,2,160,1,2,95157,94828,0,
2020-05-31,408,407,258,0,139,4,6,95565,95235,0,
2020-06-01,687,686,395,6,256,6,23,96252,95921,0,
2020-06-02,493,489,320,1,159,5,4,96745,96410,0,
2020-06-03,492,491,321,4,153,4,9,97237,96901,0,
2020-06-04,461,460,265,1,177,11,6,97698,97361,0,
2020-06-05,445,441,311,0,124,3,3,98143,97802,0,
2020-06-06,371,369,234,1,127,4,3,98514,98171,0,
2020-06-07,313,307,212,0,89,1,5,98827,98478,0,
2020-06-08,432,428,289,6,118,10,5,99259,98906,0,
2020-06-09,374,372,244,3,116,4,5,99633,99278,0,
2020-06-10,441,439,259,5,156,10,9,100074,99717,0,
2020-06-11,376,369,242,3,116,5,3,100450,100086,0,
2020-06-12,375,371,224,5,133,6,3,100825,100457,0,
2020-06-13,276,274,180,1,86,5,2,101101,100731,0,
2020-06-14,300,296,186,0,98,9,3,101401,101027,0,
2020-06-15,400,395,242,4,138,7,4,101801,101422,0,
2020-06-16,367,363,234,2,112,10,5,102168,101785,0,
2020-06-17,363,358,228,0,120,6,4,102531,102143,0,
2020-06-18,329,326,198,1,119,4,4,102860,102469,0,
2020-06-19,335,335,231,0,89,11,4,103195,102804,0,
2020-06-20,283,282,186,0,87,8,1,103478,103086,0,
2020-06-21,270,268,175,0,86,4,3,103748,103354,0,
2020-06-22,323,320,211,2,99,4,4,104071,103674,0,
2020-06-23,327,326,219,2,92,6,7,104398,104000,0,
2020-06-24,285,285,183,2,87,9,4,104683,104285,0,
2020-06-25,463,461,326,2,122,5,6,105146,104746,0,
2020-06-26,276,273,170,0,86,11,6,105422,105019,0,
2020-06-27,251,250,165,1,74,7,3,105673,105269,0,
2020-06-28,238,235,135,1,89,9,1,105911,105504,0,
2020-06-29,332,329,198,2,108,10,11,106243,105833,0,
2020-06-30,309,302,197,4,96,2,3,106552,106135,0,
2020-07-01,287,276,177,8,85,5,1,106839,106411,0,
2020-07-02,268,260,161,1,85,6,7,107107,106671,0,
2020-07-03,305,295,184,2,93,13,3,107412,106966,0,
2020-07-04,292,283,173,3,96,10,1,107704,107249,0,
2020-07-05,272,272,178,3,84,6,1,107976,107521,0,
2020-07-06,502,494,268,2,179,17,28,108478,108015,0,
2020-07-07,519,510,264,6,211,19,10,108997,108525,0,
2020-07-08,440,427,279,4,129,10,5,109437,108952,0,
2020-07-09,449,433,268,3,141,12,9,109886,109385,0,
2020-07-10,412,396,258,5,114,14,5,110298,109781,0,
2020-07-11,384,380,228,3,135,12,2,110682,110161,0,
2020-07-12,397,388,236,3,141,6,2,111079,110549,0,
2020-07-13,606,585,359,12,199,12,3,111685,111134,0,
2020-07-14,546,517,299,4,193,13,8,112231,111651,0,
2020-07-15,566,541,311,3,196,16,15,112797,112192,0,
2020-07-16,459,437,259,4,154,17,3,113256,112629,0,
2020-07-17,503,484,272,6,188,7,11,113759,113113,0,
2020-07-18,409,390,228,2,146,7,7,114168,113503,0,
2020-07-19,391,379,202,4,160,12,1,114559,113882,0,
2020-07-20,526,497,264,6,208,14,5,115085,114379,0,
2020-07-21,522,510,266,10,223,6,5,115607,114889,0,
2020-07-22,446,433,181,6,232,10,4,116053,115322,0,
2020-07-23,445,423,173,3,234,7,6,116498,115745,0,
2020-07-24,458,443,181,7,243,5,7,116956,116188,0,
2020-07-25,307,303,108,4,182,6,3,117263,116491,0,
2020-07-26,332,325,102,6,205,10,2,117595,116816,0,
2020-07-27,471,457,176,3,260,14,4,118066,117273,0,
2020-07-28,416,404,154,1,230,14,5,118482,117677,0,
2020-07-29,403,396,138,1,250,3,4,118885,118073,0,
2020-07-30,330,316,109,1,190,6,10,119215,118389,0,
2020-07-31,339,330,120,0,194,10,6,119554,118719,0,
2020-08-01,340,331,114,8,184,17,8,119894,119050,0,
2020-08-02,331,322,123,6,185,6,2,120225,119372,0,
2020-08-03,428,424,161,2,250,10,1,120653,119796,0,
2020-08-04,446,431,186,0,218,20,7,121099,120227,0,
2020-08-05,380,374,170,9,184,8,3,121479,120601,0,
2020-08-06,344,333,161,4,156,7,5,121823,120934,0,
2020-08-07,385,381,189,2,172,6,12,122208,121315,0,
2020-08-08,333,330,151,4,169,2,4,122541,121645,0,
2020-08-09,322,314,150,7,147,7,3,122863,121959,0,
2020-08-10,472,468,215,8,229,12,4,123335,122427,0,
2020-08-11,472,440,217,5,207,10,1,123807,122867,0,
2020-08-12,406,395,211,11,158,12,3,124213,123262,0,
2020-08-13,422,413,222,8,171,10,2,124635,123675,0,
2020-08-14,374,372,175,7,178,9,3,125009,124047,0,
2020-08-15,366,363,171,7,172,7,6,125375,124410,0,
2020-08-16,379,373,167,14,185,4,3,125754,124783,0,
2020-08-17,542,538,262,11,251,7,7,126296,125321,0,
2020-08-18,424,419,205,4,194,4,12,126720,125740,0,
2020-08-19,445,437,207,9,206,5,10,127165,126177,0,
2020-08-20,440,438,222,5,194,4,13,127605,126615,0,
2020-08-21,421,417,206,9,188,5,9,128026,127032,0,
2020-08-22,394,393,225,7,153,5,3,128420,127425,0,
2020-08-23,403,400,203,3,187,6,1,128823,127825,0,
2020-08-24,572,569,266,15,272,7,9,129395,128394,0,
2020-08-25,612,604,293,12,288,10,1,130007,128998,0,
2020-08-26,612,604,286,13,295,5,5,130619,129602,0,
2020-08-27,482,478,230,11,224,3,10,131101,130080,0,
2020-08-28,556,551,262,11,264,6,8,131657,130631,0,
2020-08-29,456,454,206,10,215,5,18,132113,131085,0,
2020-08-30,555,547,242,4,277,7,17,132668,131632,0,
2020-08-31,645,638,260,11,341,9,17,133313,132270,0,
2020-09-01,744,740,301,18,390,7,24,134057,133010,0,
2020-09-02,776,766,333,12,389,8,24,134833,133776,0,
2020-09-03,658,653,267,5,362,4,15,135491,134429,0,
2020-09-04,719,714,287,9,395,10,13,136210,135143,0,
2020-09-05,666,662,254,9,374,9,16,136876,135805,0,
2020-09-06,685,675,269,4,389,8,5,137561,136480,0,
2020-09-07,787,778,299,9,449,9,12,138348,137258,1,
2020-09-08,957,949,352,14,556,10,17,139305,138207,0,
2020-09-09,1007,998,376,12,587,4,19,140312,139205,0,
2020-09-10,999,987,378,6,564,9,30,141311,140192,0,
2020-09-11,972,961,358,10,569,9,15,142283,141153,0,
2020-09-12,974,966,389,8,549,3,17,143257,142119,0,
2020-09-13,967,962,345,8,591,6,12,144224,143081,0,
2020-09-14,1258,1250,478,14,724,7,27,145482,144331,0,
2020-09-15,1312,1295,449,10,796,3,37,146794,145626,0,
2020-09-16,1357,1341,494,22,796,4,25,148151,146967,0,
2020-09-17,1327,1310,480,21,777,6,26,149478,148277,0,
2020-09-18,1425,1414,521,8,850,1,34,150903,149691,0,
2020-09-19,1235,1217,393,18,782,6,18,152138,150908,0,
2020-09-20,1357,1343,419,12,867,9,36,153495,152251,0,
2020-09-21,1816,1796,562,16,1159,6,53,155311,154047,0,
2020-09-22,1859,1836,523,13,1244,7,49,157170,155883,0,
2020-09-23,1907,1895,558,15,1230,2,90,159077,157778,0,
2020-09-24,1956,1936,526,10,1305,2,93,161033,159714,0,
2020-09-25,2047,2029,563,20,1341,9,96,163080,161743,0,
2020-09-26,1878,1865,505,7,1252,4,97,164958,163608,0,
2020-09-27,1967,1949,479,10,1332,6,122,166925,165557,0,
2020-09-28,2475,2446,625,16,1667,3,135,169400,168003,0,
2020-09-29,2267,2252,553,23,1530,3,143,171667,170255,0,
2020-09-30,2253,2235,564,16,1545,1,109,173920,172490,0,
2020-10-01,2163,2153,585,9,1457,9,93,176083,174643,0,
2020-10-02,2131,2101,548,17,1422,9,105,178214,176744,0,
2020-10-03,1824,1794,475,19,1200,10,90,180038,178538,0,
2020-10-04,1840,1814,508,14,1210,4,78,181878,180352,0,
2020-10-05,2441,2401,677,20,1591,4,109,184319,182753,0,
2020-10-06,2323,2271,678,31,1430,10,122,186642,185024,0,
2020-10-07,2275,2239,689,20,1413,9,108,188917,187263,0,
2020-10-08,2234,2201,655,14,1417,10,105,191151,189464,0,
2020-10-09,2300,2254,655,18,1462,7,112,193451,191718,0,
2020-10-10,2170,2139,683,17,1350,7,82,195621,193857,0,
2020-10-11,1910,1874,604,17,1155,5,93,197531,195731,0,
2020-10-12,2335,2289,717,19,1451,8,94,199866,198020,0,
2020-10-13,2572,2515,864,22,1514,9,106,202438,200535,0,
2020-10-14,2513,2465,880,27,1449,7,102,204951,203000,0,
2020-10-15,2567,2517,841,24,1543,9,100,207518,205517,0,
2020-10-16,2659,2604,894,19,1581,4,106,210177,208121,0,
2020-10-17,2302,2255,818,25,1300,6,106,212479,210376,0,
2020-10-18,2233,2172,805,13,1250,12,92,214712,212548,0,
2020-10-19,2957,2870,1124,22,1596,7,121,217669,215418,0,
2020-10-20,2824,2755,1103,27,1465,9,151,220493,218173,0,
2020-10-21,2789,2700,1009,33,1500,9,149,223282,220873,0,
2020-10-22,2800,2687,1094,21,1442,2,128,226082,223560,0,
2020-10-23,2823,2713,1048,31,1494,7,133,228905,226273,0,
2020-10-24,2641,2553,1038,34,1321,10,150,231546,228826,0,
2020-10-25,2643,2521,1026,32,1341,7,115,234189,231347,0,
2020-10-26,3391,3258,1268,23,1763,10,194,237580,234605,0,
2020-10-27,3352,3192,1350,36,1635,9,162,240932,237797,0,
2020-10-28,3621,3489,1432,38,1812,9,198,244553,241286,0,
2020-10-29,3097,2952,1255,33,1535,7,122,247650,244238,0,
2020-10-30,3523,3373,1333,44,1832,10,154,251173,247611,0,
2020-10-31,3153,3022,1354,32,1489,8,139,254326,250633,0,
2020-11-01,3446,3297,1383,33,1725,8,148,257772,253930,0,
2020-11-02,4569,4327,1850,43,2231,7,196,262341,258257,0,
2020-11-03,4493,4276,1799,34,2152,15,276,266834,262533,0,
2020-11-04,4615,4391,1915,48,2223,7,198,271449,266924,0,
2020-11-05,4543,4325,1755,34,2246,8,282,275992,271249,0,
2020-11-06,4615,4391,1808,22,2305,10,246,280607,275640,0,
2020-11-07,4306,4110,1530,17,2344,9,210,284913,279750,0,
2020-11-08,4029,3827,1452,13,2180,8,174,288942,283577,0,
2020-11-09,5292,5024,1824,26,2914,14,246,294234,288601,0,
2020-11-10,5131,4816,1739,19,2810,14,234,299365,293417,0,
2020-11-11,4940,4687,1821,26,2618,9,213,304305,298104,0,
2020-11-12,5040,4783,1709,19,2814,12,229,309345,302887,0,
2020-11-13,5180,4935,1784,17,2897,16,221,314525,307822,0,
2020-11-14,4531,4300,1693,11,2406,13,177,319056,312122,0,
2020-11-15,4458,4185,1638,22,2358,18,149,323514,316307,0,
2020-11-16,5597,5291,2038,17,3047,21,168,329111,321598,0,
2020-11-17,5414,5121,1913,19,2952,13,224,334525,326719,0,
2020-11-18,5649,5360,2103,28,3027,12,190,340174,332079,0,
2020-11-19,5496,5195,1865,24,3080,16,210,345670,337274,0,
2020-11-20,5520,5231,1978,30,2999,15,209,351190,342505,0,
2020-11-21,5068,4823,1826,23,2790,15,169,356258,347328,0,
2020-11-22,4855,4637,1760,26,2650,22,179,361113,351965,0,
2020-11-23,6327,5998,2265,35,3440,16,242,367440,357963,0,
2020-11-24,6228,5884,2191,31,3391,10,261,373668,363847,0,
2020-11-25,6385,6090,2185,28,3546,15,316,380053,369937,0,
2020-11-26,6100,5863,2147,30,3469,17,200,386153,375800,0,
2020-11-27,6241,5984,2091,34,3625,18,216,392394,381784,0,
2020-11-28,5585,5362,1989,23,3057,15,278,397979,387146,0,
2020-11-29,5412,5165,1716,31,3168,15,235,403391,392311,0,
2020-11-30,6914,6644,2310,37,4003,21,273,410305,398955,0,
2020-12-01,6773,6497,2338,21,3874,7,257,417078,405452,0,
2020-12-02,6695,6439,2147,38,3984,13,257,423773,411891,0,
2020-12-03,6702,6394,2189,34,3863,17,291,430475,418285,0,
2020-12-04,6792,6459,2202,41,3934,10,272,437267,424744,0,
2020-12-05,5821,5563,1842,39,3421,12,249,443088,430307,0,
2020-12-06,5796,5538,1926,34,3289,31,258,448884,435845,0,
2020-12-07,7650,7284,2519,48,4344,26,347,456534,443129,0,
2020-12-08,7173,6915,2281,40,4220,16,358,463707,450044,0,
2020-12-09,6900,6627,2225,30,3982,19,371,470607,456671,0,
2020-12-10,6843,6578,2112,46,4051,24,345,477450,463249,0,
2020-12-11,6827,6594,2128,50,4040,22,354,484277,469843,0,
2020-12-12,6157,5940,1867,43,3689,24,317,490434,475783,0,
2020-12-13,5520,5319,1747,27,3251,16,278,495954,481102,0,
2020-12-14,7670,7385,2323,41,4530,29,462,503624,488487,0,
2020-12-15,7211,6938,2137,33,4322,17,429,510835,495425,0,
2020-12-16,6875,6641,2099,47,4061,9,425,517710,502066,0,
2020-12-17,6639,6401,1900,36,4030,26,409,524349,508467,0,
2020-12-18,6907,6703,2018,53,4178,20,434,531256,515170,0,
2020-12-19,5892,5748,1771,41,3619,17,300,537148,520918,0,
2020-12-20,5879,5732,1823,32,3552,20,305,543027,526650,0,
2020-12-21,7573,7317,2219,41,4571,16,470,550600,533967,0,
2020-12-22,7112,6895,2160,44,4253,22,416,557712,540862,0,
2020-12-23,7383,7175,2269,49,4383,30,444,565095,548037,0,
2020-12-24,6876,6754,2129,43,4166,14,402,571971,554791,0,
2020-12-25,5694,5588,1817,52,3430,15,274,577665,560379,0,
2020-12-26,7594,7414,2567,58,4420,24,345,585259,567793,0,
2020-12-27,7539,7387,2681,68,4246,19,373,592798,575180,0,
2020-12-28,8932,8694,3019,52,5147,25,451,601730,583874,0,
2020-12-29,8135,7890,2820,72,4537,16,445,609865,591764,0,
2020-12-30,7835,7582,2659,59,4359,39,466,617700,599346,0,
2020-12-31,7420,7193,2617,57,4079,15,425,625120,606539,0,
2021-01-01,6790,6621,2384,40,3809,27,361,631910,613160,0,
2021-01-02,7500,7297,2761,69,3992,43,432,639410,620457,0,
2021-01-03,7288,7069,2559,61,4020,48,381,646698,627526,0,
2021-01-04,8908,8595,3100,69,4840,32,554,655606,636121,0,
2021-01-05,7770,7495,2807,64,4097,48,479,663376,643616,0,
2021-01-06,7703,7411,2658,59,4089,53,552,671079,651027,0,
2021-01-07,6876,6631,2367,54,3684,37,489,677955,657658,0,
2021-01-08,6744,6505,2358,58,3561,39,489,684699,664163,0,
2021-01-09,5970,5798,2067,54,3234,40,403,690669,669961,0,
2021-01-10,5569,5404,1951,58,2989,29,377,696238,675365,0,
2021-01-11,6873,6546,2490,59,3463,36,498,703111,681911,0,
2021-01-12,6072,5802,2168,71,3087,30,446,709183,687713,0,
2021-01-13,6075,5854,2118,49,3179,32,476,715258,693567,0,
2021-01-14,5636,5401,2072,43,2817,28,441,720894,698968,0,
2021-01-15,5997,5703,2071,40,3162,30,400,726891,704671,0,
2021-01-16,4691,4530,1687,37,2500,20,286,731582,709201,0,
2021-01-17,4464,4324,1582,38,2343,36,325,736046,713525,0,
2021-01-18,5638,5380,1994,40,2840,29,477,741684,718905,0,
2021-01-19,5194,4969,1827,48,2629,12,453,746878,723874,0,
2021-01-20,5036,4790,1830,56,2512,24,368,751914,728664,0,
2021-01-21,4761,4568,1683,30,2437,26,392,756675,733232,0,
2021-01-22,4499,4298,1655,38,2279,18,308,761174,737530,0,
2021-01-23,3930,3790,1432,43,2020,15,280,765104,741320,0,
2021-01-24,3486,3345,1250,28,1813,11,243,768590,744665,0,
2021-01-25,4616,4399,1607,37,2344,18,393,773206,749064,0,
2021-01-26,4077,3884,1413,40,2082,8,341,777283,752948,0,
2021-01-27,4146,3941,1511,28,2072,15,315,781429,756889,0,
2021-01-28,3846,3647,1330,31,2010,16,260,785275,760536,0,
2021-01-29,3738,3554,1292,40,1979,14,229,789013,764090,0,
2021-01-30,3137,3001,1068,23,1674,10,226,792150,767091,0,
2021-01-31,2850,2713,1047,24,1452,18,172,795000,769804,0,
2021-02-01,4090,3805,1352,21,2039,15,378,799090,773609,0,
2021-02-02,3611,3335,1269,33,1770,10,253,802701,776944,0,
2021-02-03,3535,3209,1221,22,1721,10,235,806236,780153,0,
2021-02-04,3345,2982,1157,26,1540,13,246,809581,783135,0,
2021-02-05,3362,2789,1140,26,1364,16,243,812943,785924,0,
2021-02-06,2787,2149,1032,18,961,7,131,815730,788073,0,
2021-02-07,2630,1775,959,24,643,11,138,818360,789848,0,
2021-02-08,3488,2264,1263,19,753,9,220,821848,792112,0,
2021-02-09,3230,2026,1107,29,701,13,176,825078,794138,0,
2021-02-10,3292,2171,1248,29,756,5,133,828370,796309,0,
2021-02-11,2880,1924,1149,24,609,7,135,831250,798233,0,
2021-02-12,3100,2051,1163,21,689,7,171,834350,800284,0,
2021-02-13,2672,1875,1101,17,598,4,155,837022,802159,0,
2021-02-14,2528,1697,1003,16,567,20,91,839550,803856,0,
2021-02-15,3034,1999,1175,33,660,6,125,842584,805855,0,
2021-02-16,3004,2085,1239,26,644,13,163,845588,807940,0,
2021-02-17,3083,2124,1270,28,645,8,173,848671,810064,0,
2021-02-18,3011,2106,1259,31,614,7,195,851682,812170,0,
2021-02-19,2989,2082,1216,24,672,5,165,854671,814252,0,
2021-02-20,2739,1878,1116,26,603,10,123,857410,816130,0,
2021-02-21,2526,1791,1023,14,623,10,121,859936,817921,0,
2021-02-22,3200,2212,1296,15,703,6,192,863136,820133,0,
2021-02-23,3008,2131,1282,11,683,4,151,866144,822264,0,
2021-02-24,3106,2154,1306,18,657,7,166,869250,824418,0,
2021-02-25,2831,2007,1216,15,627,4,145,872081,826425,0,
2021-02-26,2930,2085,1277,19,624,10,155,875011,828510,0,
2021-02-27,2703,1997,1206,11,615,13,152,877714,830507,0,
2021-02-28,2646,1955,1181,21,603,9,141,880360,832462,0,
2021-03-01,3507,2534,1471,19,825,6,213,883867,834996,0,
2021-03-02,3112,2277,1384,22,693,6,172,886979,837273,0,
2021-03-03,3286,2371,1461,19,726,14,151,890265,839644,0,
2021-03-04,2859,2148,1285,22,681,15,145,893124,841792,0,
2021-03-05,3221,2396,1498,21,708,3,166,896345,844188,0,
2021-03-06,2810,2106,1280,5,659,10,152,899155,846294,0,
2021-03-07,2700,2016,1185,13,681,9,128,901855,848310,0,
2021-03-08,3543,2672,1614,12,827,19,200,905398,850982,0,
2021-03-09,3369,2580,1564,24,775,10,207,908767,853562,0,
2021-03-10,3679,2804,1711,23,825,16,229,912446,856366,0,
2021-03-11,3292,2481,1497,15,754,17,198,915738,858847,0,
2021-03-12,3397,2609,1560,10,796,15,228,919135,861456,0,
2021-03-13,3162,2431,1514,10,743,10,154,922297,863887,0,
2021-03-14,3066,2297,1369,11,742,25,150,925363,866184,0,
2021-03-15,4152,3307,1989,12,1064,17,225,929515,869491,0,
2021-03-16,4002,3118,1916,11,959,13,219,933517,872609,0,
2021-03-17,4401,3532,2225,9,1061,21,216,937918,876141,0,
2021-03-18,4009,3185,2033,13,926,16,197,941927,879326,0,
2021-03-19,4342,3423,2072,12,1086,19,234,946269,882749,0,
2021-03-20,4175,3307,1986,12,1102,8,199,950444,886056,0,
2021-03-21,4200,3326,1954,16,1106,31,219,954644,889382,0,
2021-03-22,5307,4143,2429,20,1397,13,284,959951,893525,0,
2021-03-23,5550,4333,2465,24,1514,24,306,965501,897858,0,
2021-03-24,5603,4475,2673,20,1444,28,310,971104,902333,0,
2021-03-25,5231,4083,2381,17,1367,16,302,976335,906416,0,
2021-03-26,5664,4478,2608,22,1474,25,349,981999,910894,0,
2021-03-27,5364,4220,2456,22,1459,13,270,987363,915114,0,
2021-03-28,5420,4245,2469,17,1448,30,281,992783,919359,0,
2021-03-29,6663,5290,3080,14,1822,22,352,999446,924649,0,
2021-03-30,6725,5287,3096,21,1788,29,353,1006171,929936,0,
2021-03-31,6781,5402,3154,30,1854,19,345,1012952,935338,0,
2021-04-01,7834,6340,3521,37,2204,18,560,1020786,941678,0,
2021-04-02,7155,5693,3296,35,1905,18,439,1027941,947371,0,
2021-04-03,7145,5650,3288,32,1794,16,520,1035086,953021,0,
2021-04-04,7394,5862,3353,29,1988,22,470,1042480,958883,0,
2021-04-05,9577,7706,4342,39,2624,34,667,1052057,966589,0,
2021-04-06,9588,7742,4423,50,2540,24,705,1061645,974331,0,
2021-04-07,9611,7779,4430,43,2568,27,711,1071256,982110,0,
2021-04-08,8972,7268,4082,38,2376,22,750,1080228,989378,0,
2021-04-09,9020,7257,3969,41,2457,41,749,1089248,996635,0,
2021-04-10,8547,7015,3847,41,2389,32,706,1097795,1003650,0,
2021-04-11,7802,6314,3434,32,2198,28,622,1105597,1009964,0,
2021-04-12,9273,7504,4228,40,2410,35,791,1114870,1017468,0,
2021-04-13,8642,7066,3963,32,2298,28,745,1123512,1024534,0,
2021-04-14,8793,7221,4021,38,2283,32,847,1132305,1031755,0,
2021-04-15,8084,6709,3779,29,2100,21,780,1140389,1038464,0,
2021-04-16,8272,6918,3847,23,2340,28,680,1148661,1045382,0,
2021-04-17,7872,6577,3717,36,2106,25,693,1156533,1051959,0,
2021-04-18,7180,6055,3378,26,1992,35,624,1163713,1058014,0,
2021-04-19,8757,7356,4114,36,2384,44,778,1172470,1065370,0,
2021-04-20,8269,6975,4046,27,2210,30,662,1180739,1072345,0,
2021-04-21,8183,6974,4015,28,2225,56,650,1188922,1079319,0,
2021-04-22,7625,6481,3715,18,2107,55,586,1196547,1085800,0,
2021-04-23,8058,6911,3931,33,2203,49,695,1204605,1092711,0,
2021-04-24,7280,6144,3563,22,1974,22,563,1211885,1098855,0,
2021-04-25,6750,5687,3331,21,1842,31,462,1218635,1104542,0,
2021-04-26,8182,6942,4019,27,2204,43,649,1226817,1111484,0,
2021-04-27,7633,6478,3826,21,1985,19,627,1234450,1117962,0,
2021-04-28,8120,6880,3994,27,2147,20,692,1242570,1124842,0,
2021-04-29,7119,6028,3555,24,1809,11,629,1249689,1130870,0,
2021-04-30,7373,6285,3617,24,1934,35,675,1257062,1137155,0,
2021-05-01,7005,6053,3532,18,1984,12,507,1264067,1143208,0,
2021-05-02,6119,5255,3175,27,1605,12,436,1270186,1148463,0,
2021-05-03,7514,6383,3817,26,2047,19,474,1277700,1154846,0,
2021-05-04,6873,5795,3576,22,1782,25,390,1284573,1160641,0,
2021-05-05,6729,5753,3512,27,1809,19,386,1291302,1166394,0,
2021-05-06,6156,5162,3159,11,1605,14,373,1297458,1171556,0,
2021-05-07,6274,5268,3218,18,1670,21,341,1303732,1176824,0,
2021-05-08,5598,4730,2897,25,1514,10,284,1309330,1181554,0,
2021-05-09,5007,4228,2645,20,1348,5,210,1314337,1185782,0,
2021-05-10,6285,5227,3137,26,1689,18,357,1320622,1191009,0,
2021-05-11,5476,4550,2751,26,1448,6,319,1326098,1195559,0,
2021-05-12,5443,4540,2791,18,1466,6,259,1331541,1200099,0,
2021-05-13,4947,4099,2541,18,1295,12,233,1336488,1204198,0,
2021-05-14,4885,4052,2410,11,1346,10,275,1341373,1208250,0,
2021-05-15,4285,3547,2144,9,1157,9,228,1345658,1211797,0,
2021-05-16,3788,3119,1851,6,1079,11,172,1349446,1214916,0,
2021-05-17,4522,3696,2204,8,1171,13,300,1353968,1218612,0,
2021-05-18,4079,3286,1934,11,1068,6,267,1358047,1221898,0,
2021-05-19,3697,2993,1817,13,968,2,193,1361744,1224891,0,
2021-05-20,3482,2822,1681,9,885,6,241,1365226,1227713,0,
2021-05-21,3256,2632,1566,7,832,7,220,1368482,1230345,0,
2021-05-22,2637,2170,1306,8,712,4,140,1371119,1232515,0,
2021-05-23,2303,1847,1095,1,635,3,113,1373422,1234362,0,
2021-05-24,2409,1944,1158,6,662,2,116,1375831,1236306,0,
2021-05-25,2684,2149,1344,1,662,5,137,1378515,1238455,0,
2021-05-26,2403,1924,1208,7,602,4,103,1380918,1240379,0,
2021-05-27,2220,1788,1151,6,535,5,91,1383138,1242167,0,
2021-05-28,2089,1671,1072,3,506,3,87,1385227,1243838,0,
2021-05-29,1675,1340,822,1,437,7,73,1386902,1245178,0,
2021-05-30,1528,1237,787,6,387,7,50,1388430,1246415,0,
2021-05-31,1973,1577,1033,1,461,6,76,1390403,1247992,0,
2021-06-01,1845,1500,931,8,470,7,84,1392248,1249492,0,
2021-06-02,1724,1373,894,3,416,2,58,1393972,1250865,0,
2021-06-03,1495,1212,788,5,356,4,59,1395467,1252077,0,
2021-06-04,1483,1155,731,3,353,5,63,1396950,1253232,0,
2021-06-05,1224,991,637,3,302,5,44,1398174,1254223,0,
2021-06-06,1098,865,562,0,264,2,37,1399272,1255088,0,
2021-06-07,1440,1136,748,3,326,5,54,1400712,1256224,0,
2021-06-08,1200,945,583,2,297,8,55,1401912,1257169,0,
2021-06-09,1202,952,636,6,236,7,67,1403114,1258121,0,
2021-06-10,1170,908,621,6,220,8,53,1404284,1259029,0,
2021-06-11,1050,816,521,1,232,10,52,1405334,1259845,0,
2021-06-12,903,710,452,4,185,9,60,1406237,1260555,0,
2021-06-13,764,604,375,2,182,2,43,1407001,1261159,0,
2021-06-14,1031,781,506,3,219,13,40,1408032,1261940,0,
2021-06-15,901,686,460,0,194,6,26,1408933,1262626,0,
2021-06-16,846,636,419,1,165,11,40,1409779,1263262,0,
2021-06-17,711,530,355,2,143,6,24,1410490,1263792,0,
2021-06-18,723,564,365,2,150,16,31,1411213,1264356,0,
2021-06-19,562,446,260,0,144,6,36,1411775,1264802,0,
2021-06-20,561,425,248,3,133,5,36,1412336,1265227,0,
2021-06-21,690,544,327,1,166,7,43,1413026,1265771,0,
2021-06-22,657,497,300,2,148,6,41,1413683,1266268,0,
2021-06-23,659,490,313,1,140,3,33,1414342,1266758,0,
2021-06-24,575,451,269,4,131,11,36,1414917,1267209,0,
2021-06-25,518,408,253,1,112,6,36,1415435,1267617,0,
2021-06-26,454,345,206,2,110,7,20,1415889,1267962,0,
2021-06-27,418,308,175,0,98,4,31,1416307,1268270,0,
2021-06-28,538,400,234,1,115,9,41,1416845,1268670,0,
2021-06-29,466,344,167,2,117,12,46,1417311,1269014,0,
2021-06-30,446,370,203,4,108,10,45,1417757,1269384,0,
2021-07-01,368,283,159,3,93,11,17,1418125,1269667,0,
2021-07-02,394,313,164,0,102,4,43,1418519,1269980,0,
2021-07-03,384,328,179,2,114,11,22,1418903,1270308,0,
2021-07-04,346,291,155,2,111,2,21,1419249,1270599,0,
2021-07-05,407,352,199,3,116,5,29,1419656,1270951,0,
2021-07-06,398,344,201,4,114,7,18,1420054,1271295,0,
2021-07-07,341,296,162,3,105,9,17,1420395,1271591,0,
2021-07-08,275,233,130,3,76,8,16,1420670,1271824,0,
2021-07-09,293,253,123,2,96,10,22,1420963,1272077,,
2021-07-10,259,241,126,2,96,10,7,1421222,1272318,,
2021-07-11,242,220,123,0,78,11,8,1421464,1272538,,
2021-07-12,345,307,154,1,128,6,18,1421809,1272845,,
2021-07-13,292,256,122,0,100,4,30,1422101,1273101,,
2021-07-14,323,268,134,0,100,9,25,1422424,1273369,,
2021-07-15,270,228,114,1,85,9,19,1422694,1273597,,
2021-07-16,257,204,98,6,72,4,24,1422951,1273801,,
2021-07-17,189,154,84,2,47,1,20,1423140,1273955,,
2021-07-18,172,130,66,0,44,2,18,1423312,1274085,,
2021-07-19,219,121,54,0,41,4,22,1423531,1274206,,
2021-07-20,162,97,38,0,20,0,39,1423693,1274303,,
2021-07-21,83,68,8,0,9,0,51,1423776,1274371,,
2021-07-22,2,2,0,0,0,0,2,1423778,1274373,,